Absurd	(ridiculous, senseless, foolish) [Expansion Set 2, Party Set]
Abundant	(plentiful, ample, numerous) [Expansion Set 2]
Addictive	(obsessive, consuming, captivating) [Expansion Set 1, Party Set]
Adorable	(lovable, charming, delightful) [Basic Set, Party Set]
Adorable	(lovable, cute) [Junior 9+ (2nd)]
Aged	(old, ancient, mature) [Expansion Set 2, Party Set]
Amazing	(astonishing, surprising, wonderful) [Expansion Set 3, Party Expansion 1]
Amazing	(surprising, wonderful) [Junior 9+ (1st) & (2nd)]
American	(U.S. Citizen, Yankee, Apple Pie) [Expansion Set 2, Party Set]
Ancient	(elderly, old, antique) [Basic Set, Party Set]
Animated	(lively, exuberant, spirited) [Basic Set, Party Set]
Annoying	(irritating, bothersome, teasing) [Expansion Set 1, Party Set]
Annoying	(bothersome, irritating) [Junior 9+ (2nd)]
Appetizing	(appealing, tasty, flavorful) [Expansion Set 2, Party Set]
Armed & Dangerous	(hazardous, threatening, fortified) [Expansion Set 4, Party Expansion 1]
Arrogant	(egotistical, overconfident, conceited) [Basic Set, Party Set]
Attractive	(alluring, engaging, good-looking) [Expansion Set 3, Party Expansion 1]
Attractive	(pretty, good-looking) [Junior 9+ (2nd)]
Awesome	(amazing, remarkable, majestic) [Expansion Set 1, Party Set]
Awful	(very bad, horrible) [Junior 9+ (1st) & (2nd)]
Awkward	(clumsy, bumbling, uncoordinated) [Basic Set, Party Set]
Bad	(rotten, hurtful) [Junior]
Bashful	(shy, timid, modest) [Expansion Set 3, Party Expansion 1]
Beautiful	(pretty, lovely) [Junior 9+ (1st) & (2nd)]
Believable	(trustworthy, credible, convincing) [Expansion Set 1, Party Set]
Best	(greatest, finest) [Junior 9+ (2nd)]
Big	(large, huge) [Junior]
Big & Tall	(large, bulky, gigantic) [Expansion Set 4, Party Expansion 1]
Bitter	(sour, tart) [Junior 9+ (2nd)]
Black & Blue	(bruised, battered, rough) [Expansion Set 4, Party Expansion 1]
Black & White	(indisputable, distinct, written) [Expansion Set 4, Party Expansion 1]
Bogus	(fraudulent, phony, insincere) [Expansion Set 1, Party Set]
Boisterous	(loud, rambunctious, rowdy) [Basic Set, Party Set]
Bold	(daring, brave, courageous) [Expansion Set 1, Party Set]
Bold	(daring, courageous) [Junior 9+ (2nd)]
Boring	(dull, tedious, monotonous) [Basic Set, Party Set]
Boring	(not interesting, dull) [Junior]
Brains & Brawn	(solid, strong, capable) [Expansion Set 4, Party Expansion 1]
Brave	(fearless, courageous) [Junior]
Bright	(brilliant, radiant, shiny) [Expansion Set 1, Party Set]
Bright	(light, intelligent) [Junior 9+ (2nd)]
Bright & Shining	(radiant, sparkling, gleaming) [Expansion Set 4, Party Expansion 1]
Brilliant	(dazzling, gleaming, intelligent) [Basic Set, Party Set]
Brutal	(cruel, crude, harsh) [Expansion Set 3, Party Expansion 1]
Bumpy	(lumpy, bouncy) [Junior 9+ (1st) & (2nd)]
Busy	(occupied, meddlesome, engrossed) [Expansion Set 2, Party Set]
Busy	(active, unavailable) [Junior 9+ (1st) & (2nd)]
Calm	(peaceful, tranquil, placid) [Basic Set, Party Set]
Calm	(peaceful, still) [Junior 9+ (1st) & (2nd)]
Careful	(cautious, thoughtful) [Junior 9+ (1st) & (2nd)]
Caring	(concerned, interested) [Junior 9+ (2nd)]
Casual	(easygoing, blase, nonchalant) [Basic Set, Party Set]
Charismatic	(alluring, magnetic, charming) [Expansion Set 2, Party Set]
Charming	(captivating, enchanting, fascinating) [Basic Set, Party Set]
Charming	(pleasant, polite) [Junior 9+ (2nd)]
Cheerful	(happy, lively) [Junior 9+ (1st) & (2nd)]
Cheesy	(trashy, tawdry, far-fetched) [Basic Set, Party Set]
Chewy	(gummy, rubbery, stringy) [Expansion Set 1, Party Set]
Chewy	(gummy, rubbery) [Junior 9+ (1st) & (2nd)]
Chubby	(plump, round) [Junior 9+ (2nd)]
Chunky	(lumpy, chubby, bumpy) [Expansion Set 1, Party Set]
Classic	(timeless, definitive, vintage) [Expansion Set 1, Party Set]
Clean	(washed, pure, tidy) [Expansion Set 2, Party Set]
Clean	(spotless, clear) [Junior]
Clear	(understandable, uncluttered, transparent) [Expansion Set 1]
Clever	(intelligent, ingenious, witty) [Expansion Set 3, Party Expansion 1]
Clueless	(unaware, oblivious, ignorant) [Expansion Set 1, Party Set]
Clumsy	(awkward, bumbling, uncoordinated) [Expansion Set 3, Party Expansion 1]
Clumsy	(awkward, not graceful) [Junior 9+ (1st) & (2nd)]
Cold	(chilly, icy, aloof) [Expansion Set 2, Party Set]
Cold	(cool, chilly) [Junior]
Colorful	(vivid, brilliant, kaleidoscopic) [Basic Set, Party Set]
Colorful	(full of color, bright) [Junior]
Comfortable	(cozy, snug, restful) [Expansion Set 2, Party Set]
Comfortable	(cozy, pleasant) [Junior 9+ (1st) & (2nd)]
Comical	(funny, hilarious, amusing) [Expansion Set 2, Party Set]
Complicated	(difficult, complex, involved) [Expansion Set 1, Party Set]
Conceited	(vain, smug, self-centered) [Expansion Set 3, Party Expansion 1]
Confused	(muddled, bewildered, perplexed) [Expansion Set 1, Party Set]
Confusing	(puzzling, weird) [Junior 9+ (2nd)]
Controversial	(contentious, disputable, debatable) [Expansion Set 3, Party Expansion 1]
Cool	(chilly, hip, cold-blooded) [Basic Set, Party Set]
Cool	(not hot, chilled) [Junior 9+ (1st) & (2nd)]
Cool & Collected	(controlled, composed, restrained) [Expansion Set 4, Party Expansion 1]
Corrupt	(dishonest, underhanded, shady) [Basic Set, Party Set]
Cosmic	(limitless, planetary, far out) [Expansion Set 2, Party Set]
Cosmopolitan	(sophisticated, urbane, well-informed) [Party Set]
Costly	(expensive, valuable) [Junior 9+ (2nd)]
Courageous	(brave, gallant, dauntless) [Basic Set, Party Set]
Courageous	(brave, bold) [Junior 9+ (2nd)]
Cowardly	(fearful, afraid, spineless) [Expansion Set 1, Party Set]
Cozy	(comfortable, snug, warm) [Expansion Set 3, Party Expansion 1]
Cozy	(comfortable, warm) [Junior 9+ (1st) & (2nd)]
Cranky	(crabby, cantankerous, grouchy) [Expansion Set 2, Party Set]
Crazed	(insane, wild, deranged) [Basic Set, Party Set]
Crazy	(insane, bizarre, wacky) [Expansion Set 1, Party Set]
Crazy	(silly, foolish) [Junior 9+ (1st) & (2nd)]
Creative	(imaginative, artistic, original) [Basic Set, Party Set]
Creepy	(frightening, slithering, scary) [Basic Set, Party Set]
Creepy	(spooky, scary) [Junior]
Creepy & Crawly	(frightening, ghastly, icky) [Expansion Set 4, Party Expansion 1]
Crisp	(brittle, brisk, fresh) [Expansion Set 3, Party Expansion 1]
Crisp & Delicious	(tasty, crunchy, savory) [Expansion Set 4, Party Expansion 1]
Crooked	(bent, not straight) [Junior 9+ (2nd)]
Cruel	(mean, harsh, merciless) [Party Set]
Cruel & Unusual	(barbaric, merciless, unwarranted) [Expansion Set 4, Party Expansion 1]
Crunchy	(crispy, crackling) [Junior 9+ (1st) & (2nd)]
Cuddly	(loving, tender, huggable) [Basic Set, Party Set]
Cuddly	(cozy, soft) [Junior 9+ (1st) & (2nd)]
Curved	(bent, rounded) [Junior 9+ (2nd)]
Cut & Dried	(settled, obvious, indisputable) [Expansion Set 4, Party Expansion 1]
Cute	(pretty, perky, delightful) [Expansion Set 2, Party Set]
Cute	(pretty, good-looking) [Junior]
Cute & Cuddly	(adorable, precious, huggable) [Expansion Set 4, Party Expansion 1]
Dainty	(delicate, fragile, thin) [Basic Set, Party Set]
Dainty	(delicate, elegant) [Junior 9+ (2nd)]
Dangerous	(risky, chancy, hazardous) [Basic Set, Party Set]
Dangerous	(unsafe, risky) [Junior]
Daring	(brave, bold) [Junior 9+ (2nd)]
Dark	(unlit, morbid, sinister) [Expansion Set 3, Party Expansion 1]
Dark	(without light, nearly black) [Junior]
Dashing	(gallant, bold, elegant) [Expansion Set 3, Party Expansion 1]
Dazed & Confused	(stunned, bewildered, disoriented) [Expansion Set 4, Party Expansion 1]
Dead	(deceased, expired, unresponsive) [Expansion Set 2, Party Set]
Dead & Gone	(deceased, defunct, passe) [Expansion Set 4, Party Expansion 1]
Deadly	(fatal, lethal, murderous) [Expansion Set 1, Party Set]
Delicate	(dainty, tender, elegant) [Basic Set, Party Set]
Delicate	(breakable, dainty) [Junior 9+ (1st) & (2nd)]
Delicious	(tasty, pleasing, appetizing) [Basic Set, Party Set]
Delicious	(tasty, pleasing) [Junior 9+ (1st) & (2nd)]
Delightful	(pleasing, enjoyable, charming) [Expansion Set 1, Party Set]
Demanding	(difficult, exacting, bothersome) [Basic Set, Party Set]
Depressing	(dismal, gloomy, sad) [Expansion Set 2, Party Set]
Desperate	(frantic, headlong, reckless) [Basic Set, Party Set]
Devious	(sneaky, shifty, tricky) [Expansion Set 3, Party Expansion 1]
Difficult	(complicated, hard) [Junior 9+ (2nd)]
Dignified	(stately, honorable, distinguished) [Expansion Set 1, Party Set]
Dirty	(unclean, soiled, impure) [Expansion Set 2, Party Set]
Dirty	(unclean, filthy) [Junior]
Disgusting	(sickening, horrible) [Junior 9+ (2nd)]
Distinguished	(dignified, extraordinary, acclaimed) [Basic Set, Party Set]
Disturbing	(unsettling, troubling, worrisome) [Expansion Set 1, Party Set]
Down & Dirty	(nasty, vicious, unscrupulous) [Expansion Set 4, Party Expansion 1]
Down & Out	(destitute, impoverished, penniless) [Expansion Set 4, Party Expansion 1]
Dramatic	(exciting, sensational, theatrical) [Basic Set, Party Set]
Dreamy	(fanciful, whimsical, heavenly) [Expansion Set 1, Party Set]
Drunk & Disorderly	(intoxicated, unruly, rowdy) [Expansion Set 4, Party Expansion 1]
Dull	(boring, stupid, blunt) [Party Set]
Dull	(not sharp, plain) [Junior 9+ (1st) & (2nd)]
Dumb	(silent, not smart) [Junior 9+ (2nd)]
Dumb & Dumber	(stupid, dull, rediculous) [Expansion Set 4, Party Expansion 1]
Dysfunctional	(impaired, damaged, maladjusted) [Expansion Set 2, Party Set]
Earthy	(unrefined, natural, crude) [Basic Set, Party Set]
Easy	(effortless, gentle, promiscuous) [Basic Set, Party Set]
Easy	(simple, not hard) [Junior 9+ (1st) & (2nd)]
Eccentric	(peculiar, odd, bizarre) [Expansion Set 2, Party Set]
Edgy	(irritable, nervous, tense) [Expansion Set 3, Party Expansion 1]
Elderly	(old, aged) [Junior 9+ (2nd)]
Elitist	(snobbish, arrogant, smug) [Expansion Set 2, Party Set]
Emotional	(passionate, moving, volatile) [Expansion Set 2, Party Set]
Enchanting	(captivating, charming, spell-binding) [Expansion Set 3, Party Expansion 1]
Endangered	(at risk, threatened, unprotected) [Expansion Set 3, Party Expansion 1]
Energetic	(active, vigorous, forceful) [Expansion Set 3, Party Expansion 1]
Energetic	(active, lively) [Junior 9+ (2nd)]
Enjoyable	(pleasurable, entertaining, fun) [Expansion Set 3, Party Expansion 1]
Enjoyable	(pleasant, fun) [Junior 9+ (1st) & (2nd)]
Enormous	(large, huge, gigantic) [Expansion Set 3, Party Expansion 1]
Enormous	(huge, gigantic) [Junior 9+ (2nd)]
Entertaining	(amusing, festive, enjoyable) [Expansion Set 3, Party Expansion 1]
Entertaining	(interesting, fun) [Junior 9+ (2nd)]
Eternal	(timeless, immortal, perpetual) [Expansion Set 2, Party Set]
European	(of Europe, from Europe, about Europe) [Expansion Set 2, Party Set]
Evil	(wicked, corrupt, depraved) [Expansion Set 3, Party Expansion 1]
Excellent	(very good, outstanding) [Junior 9+ (1st) & (2nd)]
Exciting	(thrilling, breathtaking, arousing) [Expansion Set 1, Party Set]
Exciting	(thrilling, interesting) [Junior]
Exhausting	(weakening, tiring, draining) [Expansion Set 2, Party Set]
Expensive	(costly, valuable, exorbitant) [Basic Set, Party Set]
Expensive	(costly, high priced) [Junior 9+ (1st) & (2nd)]
Explosive	(bursting, blasting, dangerous) [Expansion Set 1, Party Set]
Exquisite	(excellent, refined, flawless) [Expansion Set 2, Party Set]
Extreme	(exceptional, superlative, radical) [Basic Set, Party Set]
Fabulous	(marvelous, wonderful, incredible) [Basic Set, Party Set]
Fake	(unreal, counterfeit, deceptive) [Expansion Set 2, Party Set]
Famous	(well-known, celebrated, distinguished) [Expansion Set 3, Party Expansion 1]
Famous	(well-known, important) [Junior 9+ (2nd)]
Fancy	(showy, ornate, decorated) [Expansion Set 1, Party Set]
Fancy	(decorated, elegant) [Junior]
Fantastic	(awesome, outrageous, imaginary) [Expansion Set 1, Party Set]
Fascinating	(interesting, attractive) [Junior 9+ (2nd)]
Fashionable	(stylish, dashing, current) [Expansion Set 3, Party Expansion 1]
Fast	(swift, quick, rapid) [Expansion Set 3, Party Expansion 1]
Fast	(speedy, quick) [Junior]
Fast & Furious	(wild, reckless, breakneck) [Expansion Set 4, Party Expansion 1]
Fast & Loose	(deceitful, fraudulent, reckless) [Expansion Set 4, Party Expansion 1]
Fat	(plump, thick) [Junior]
Fat & Happy	(content, satisfied, assured) [Expansion Set 4, Party Expansion 1]
Favorite	(preferred, desired) [Junior 9+ (2nd)]
Fearful	(scared, worried) [Junior 9+ (2nd)]
Feminine	(womanly, ladylike, unmanly) [Basic Set, Party Set]
Filthy	(dirty, foul, unclean) [Basic Set, Party Set]
Fine	(worthy, delicate, all right) [Expansion Set 2]
Flaky	(foolish, eccentric, crispy) [Expansion Set 3, Party Expansion 1]
Flamboyant	(ornate, pompous, extravagant) [Expansion Set 3, Party Expansion 1]
Flat	(smooth, level) [Junior 9+ (2nd)]
Flavorful	(tasty, savory, pungent) [Expansion Set 3, Party Expansion 1]
Flavorful	(tasty, appetizing) [Junior 9+ (2nd)]
Flawed	(imperfect, defective, unsound) [Expansion Set 3, Party Expansion 1]
Flirtatious	(brazen, saucy, forward) [Basic Set, Party Set]
Foot Loose & Fancy Free	(lighthearted, carefree, spontaneous) [Expansion Set 4, Party Expansion 1]
Foreign	(alien, unfamiliar, exotic) [Expansion Set 1, Party Set]
Fragile	(delicate, frail, breakable) [Expansion Set 3, Party Expansion 1]
Fragile	(delicate, weak) [Junior 9+ (1st) & (2nd)]
Fragrant	(aromatic, odorous, perfumed) [Basic Set, Party Set]
Frail	(fragile, weak) [Junior 9+ (2nd)]
Frazzled	(exhausted, frayed, worn) [Basic Set, Party Set]
Fresh	(new, original, good) [Basic Set, Party Set]
Fresh	(new, clean) [Junior 9+ (1st) & (2nd)]
Friendly	(affectionate, comforting, welcoming) [Expansion Set 2, Party Set]
Friendly	(kind, nice) [Junior 9+ (1st) & (2nd)]
Frightening	(scary, horrifying, awesome) [Basic Set, Party Set]
Frightening	(scary, horrifying) [Junior 9+ (1st) & (2nd)]
Frivolous	(trivial, silly, shallow) [Party Set]
Funky	(groovy, psychedelic, hip) [Expansion Set 1, Party Set]
Fun	(enjoyable, playful, amusing) [Expansion Set 3, Party Expansion 1]
Fun	(enjoyable, playful) [Junior]
Funny	(amusing, comic, odd) [Expansion Set 1, Party Set]
Funny	(silly, goofy) [Junior]
Furious	(angry, raging, wild) [Expansion Set 1, Party Set]
Furry	(hairy, fuzzy) [Junior 9+ (1st) & (2nd)]
Fuzzy	(downy, unclear, furry) [Expansion Set 2, Party Set]
Fuzzy	(furry, fuzz-covered) [Junior]
Gentle	(tame, mild) [Junior 9+ (1st) & (2nd)]
Gigantic	(huge, large) [Junior 9+ (2nd)]
Glamorous	(beautiful, dazzling, stylish) [Expansion Set 1, Party Set]
Glitzy	(flashy, showy, gaudy) [Expansion Set 2, Party Set]
Global	(world-wide, spherical, universal) [Expansion Set 2, Party Set]
Gloomy	(dreary, depressing, sullen) [Expansion Set 3, Party Expansion 1]
Glorious	(magnificent, delightful, splendid) [Expansion Set 2, Party Set]
Good	(not bad, fine) [Junior]
Goody-Goody	(sweet, well-behaved, virtuous) [Expansion Set 2, Party Set]
Goofy	(silly, foolish, giddy) [Expansion Set 3, Party Expansion 1]
Goofy	(silly, weird) [Junior 9+ (1st) & (2nd)]
Gorgeous	(beautiful, stunning, magnificent) [Expansion Set 3, Party Expansion 1]
Gorgeous	(beautiful, dazzling) [Junior 9+ (2nd)]
Graceful	(elegant, supple, limber) [Basic Set, Party Set]
Graceful	(elegant, flowing) [Junior 9+ (2nd)]
Great	(very good, important) [Junior]
Grueling	(demanding, exhausting, strenuous) [Expansion Set 3, Party Expansion 1]
Gruesome	(ghastly, hideous, grisly) [Expansion Set 3, Party Expansion 1]
Grungy	(dirty, shabby, seedy) [Expansion Set 3, Party Expansion 1]
Hairy	(not bald, furry) [Junior]
Hale & Hearty	(healthy, vigorous, robust) [Expansion Set 4, Party Expansion 1]
Handsome	(attractive, elegant, fine) [Basic Set, Party Set]
Handy	(convenient, available, capable) [Expansion Set 3, Party Expansion 1]
Handy	(useful, helpful) [Junior 9+ (2nd)]
Happy	(glad, jolly) [Junior]
Hard	(not soft, difficult) [Junior]
Hardworking	(industrious, diligent, busy) [Basic Set, Party Set]
Hardworking	(industrious, careful) [Junior 9+ (2nd)]
Harmful	(hurtful, unhealthy, damaging) [Expansion Set 1, Party Set]
Harmful	(hurtful, damaging) [Junior 9+ (1st) & (2nd)]
Harsh	(severe, glaring, brutal) [Expansion Set 3, Party Expansion 1]
Haunting	(unforgettable, bewitching, unearthly) [Expansion Set 2, Party Set]
Hazardous	(risky, dangerous, perilous) [Expansion Set 3, Party Expansion 1]
Healthy	(hearty, robust, wholesome) [Expansion Set 2, Party Set]
Healthy	(not sick, well) [Junior 9+ (1st) & (2nd)]
Heartless	(insensitive, cruel, uncaring) [Expansion Set 1, Party Set]
Heavy	(not light, bulky) [Junior]
Helpful	(useful, assisting) [Junior]
High & Dry	(abandoned, alone, helpless) [Expansion Set 4, Party Expansion 1]
High & Low	(everywhere, universally, all over) [Expansion Set 4, Party Expansion 1]
High & Mighty	(arrogant, conceited, vain) [Expansion Set 4, Party Expansion 1]
Hilarious	(funny, witty, amusing) [Basic Set, Party Set]
Hit & Miss	(sporadic, unreliable, erratic) [Expansion Set 4, Party Expansion 1]
Honest	(trustworthy, truthful) [Junior 9+ (1st) & (2nd)]
Honorable	(honest, just, virtuous) [Basic Set, Party Set]
Hopeless	(pessimistic, desperate, downhearted) [Basic Set, Party Set]
Horrible	(frightening, awful) [Junior 9+ (1st) & (2nd)]
Horrifying	(offensive, abominable, disgusting) [Basic Set, Party Set]
Hostile	(antagonistic, aggressive, warlike) [Basic Set, Party Set]
Hot	(blazing, heated, spicy) [Expansion Set 1, Party Set]
Hot	(very warm, heated) [Junior]
Hot & Bothered	(annoyed, irritated, provoked) [Expansion Set 4, Party Expansion 1]
Hot & Cold	(ambivalent, indecisive, varying) [Expansion Set 4, Party Expansion 1]
Hot & Heavy	(passionate, momentous, serious) [Expansion Set 4, Party Expansion 1]
Hot & Muggy	(sultry, humid, oppressive) [Expansion Set 4, Party Expansion 1]
Hot & Spicy	(zesty, stimulating, pungent) [Expansion Set 4, Party Expansion 1]
Hot & Sweaty	(sweltering, intense, perspiring) [Expansion Set 4, Party Expansion 1]
Huge	(gigantic, immense, important) [Expansion Set 3, Party Expansion 1]
Huge	(big, large) [Junior 9+ (1st) & (2nd)]
Humorous	(funny, amusing, comical) [Expansion Set 3, Party Expansion 1]
Icky	(sickening, disgusting, repulsive) [Expansion Set 3, Party Expansion 1]
Ideal	(perfect, flawless, model) [Expansion Set 3, Party Expansion 1]
Idiotic	(foolish, dumb, moronic) [Basic Set, Party Set]
Important	(significant, substantial, momentous) [Basic Set, Party Set]
Important	(valuable, worthwhile) [Junior]
Industrious	(diligent, busy, hard-working) [Basic Set, Party Set]
Influential	(powerful, prominent, important) [Basic Set, Party Set]
Innocent	(guiltless, pure, naive) [Expansion Set 2, Party Set]
Insane	(psychotic, deranged, mad) [Expansion Set 2, Party Set]
Inspirational	(exhilarating, inspiring, stimulating) [Basic Set, Party Set]
Insulting	(offending, discourteous, rude) [Expansion Set 2, Party Set]
Intelligent	(bright, smart, brainy) [Expansion Set 1, Party Set]
Intense	(extreme, passionate, strained) [Expansion Set 1, Party Set]
Interesting	(fascinating, exciting) [Junior 9+ (2nd)]
Irresistible	(overpowering, overwhelming, compelling) [Expansion Set 2, Party Set]
Irritating	(annoying, troublesome, provoking) [Expansion Set 1, Party Set]
Jolly	(cheerful, joyous, merry) [Expansion Set 3, Party Expansion 1]
Jolly	(cheerful, fun) [Junior]
Juicy	(drippy, luscious, tantalizing) [Expansion Set 1, Party Set]
Juicy	(wet, squishy) [Junior]
Kind	(nice, helpful) [Junior 9+ (1st) & (2nd)]
Large	(big, not small) [Junior]
Lazy	(lifeless, apathetic, weary) [Expansion Set 2, Party Set]
Lazy	(slow, careless) [Junior 9+ (1st) & (2nd)]
Lean & Mean	(vigorous, fit, efficient) [Expansion Set 4, Party Expansion 1]
Legendary	(famous, distinctive, prominent) [Expansion Set 2, Party Set]
Lewd & Lascivious	(lustful, obscene, indecent) [Expansion Set 4, Party Expansion 1]
Light	(not dark, not heavy) [Junior]
Light & Fluffy	(billowy, airy, soft) [Expansion Set 4, Party Expansion 1]
Little	(small, tiny) [Junior 9+ (1st) & (2nd)]
Lively	(cheerful, active) [Junior]
Long	(not short, stretched) [Junior 9+ (2nd)]
Long & Lean	(slender, lanky, wiry) [Expansion Set 4, Party Expansion 1]
Loud	(noisy, boisterous, deafening) [Basic Set, Party Set]
Loud	(noisy, not quiet) [Junior]
Loud & Clear	(definite, explicit, unequivocal) [Expansion Set 4, Party Expansion 1]
Lovable	(adorable, endearing, cuddly) [Expansion Set 1, Party Set]
Lovable	(adorable, enchanting) [Junior 9+ (2nd)]
Loving	(caring, kind) [Junior 9+ (1st) & (2nd)]
Lucky	(fortunate, serendipitous, favored) [Basic Set, Party Set]
Lucky	(fortunate, favored) [Junior 9+ (1st) & (2nd)]
Lumpy	(bumpy, clumpy) [Junior]
Luscious	(delicious, savory, juicy) [Basic Set, Party Set]
Luxurious	(opulent, lavish, sumptuous) [Basic Set, Party Set]
Magical	(enchanting, miraculous, marvelous) [Basic Set, Party Set]
Magical	(mysterious, delightful) [Junior 9+ (2nd)]
Manly	(masculine, virile, strong) [Expansion Set 2, Party Set]
Masculine	(male, manly, virile) [Basic Set, Party Set]
Mean	(malicious, ill-tempered, petty) [Expansion Set 3, Party Expansion 1]
Mean	(unkind, nasty) [Junior]
Meek	(shy, mild, timid) [Expansion Set 2, Party Set]
Meek & Mild	(timid, docile, gentle) [Expansion Set 4, Party Expansion 1]
Melodramatic	(theatrical, sensational, showy) [Party Set]
Mesmerizing	(fascinating, hypnotizing, charming) [Expansion Set 3, Party Expansion 1]
Messy	(sloppy, disorderly, unclean) [Expansion Set 3, Party Expansion 1]
Messy	(sloppy, dirty) [Junior 9+ (1st) & (2nd)]
Mischievous	(naughty, prankish, sly) [Basic Set, Party Set]
Miserable	(wretched, pitiful, forlorn) [Expansion Set 2, Party Set]
Miserable	(unhappy, sorrowful) [Junior 9+ (2nd)]
Misunderstood	(not grasped, not learned, not absorbed) [Basic Set, Party Set]
Modern	(contemporary, fashionable, trendy) [Expansion Set 3, Party Expansion 1]
Mushy	(soft, squishy) [Junior 9+ (1st) & (2nd)]
Mysterious	(secretive, puzzling, strange) [Expansion Set 1, Party Set]
Mysterious	(strange, secretive) [Junior 9+ (2nd)]
Mystical	(spiritual, secretive, esoteric) [Expansion Set 2, Party Set]
Naive	(unsophisticated, childlike, simple) [Expansion Set 1, Party Set]
Nasty	(mean, inclement, offensive) [Basic Set, Party Set]
Nasty	(mean, wicked) [Junior 9+ (2nd)]
Natural	(pure, simple, unadorned) [Expansion Set 1, Party Set]
Natural	(normal, pure) [Junior 9+ (2nd)]
Naughty & Nice	(impish, mischievous, playful) [Expansion Set 4, Party Expansion 1]
Neat	(tidy, orderly, cool) [Expansion Set 2, Party Set]
Neat	(clean, orderly) [Junior 9+ (1st) & (2nd)]
Neat & Clean	(spotless, tidy, shipshape) [Expansion Set 4, Party Expansion 1]
Neglected	(ignored, disregarded, rejected) [Expansion Set 2, Party Set]
Nerdy	(unhip, uncool, dorky) [Basic Set, Party Set]
New	(fresh, modern) [Junior]
New & Improved	(upgraded, enhanced, revised) [Expansion Set 4, Party Expansion 1]
Nice	(pleasant, kind) [Junior]
Noisy	(loud, not quiet) [Junior]
Normal	(usual, common, ordinary) [Basic Set, Party Set]
Nutty	(kooky, foolish, nutlike) [Expansion Set 3, Party Expansion 1]
Obnoxious	(offensive, repulsive, annoying) [Basic Set, Party Set]
Obscene	(offensive, indecent, lewd) [Expansion Set 3, Party Expansion 1]
Odd	(different, eccentric, bizarre) [Basic Set, Party Set]
Odd	(unusual, strange) [Junior 9+ (1st) & (2nd)]
Offensive	(insulting, vulgar, attacking) [Basic Set, Party Set]
Old	(aged, elderly, antiquated) [Expansion Set 3, Party Expansion 1]
Old	(not new, used) [Junior]
Old & Cranky	(crabby, cantankerous, aged) [Expansion Set 4, Party Expansion 1]
Old & Wise	(experienced, judicious, shrewd) [Expansion Set 4, Party Expansion 1]
On The Up & Up	(trustworthy, irreproachable, honest) [Expansion Set 4, Party Expansion 1]
Orderly	(methodical, formal, systematic) [Expansion Set 2]
Ordinary	(usual, common, plain) [Basic Set (2001 Printing Forward), Party Set]
Ordinary	(normal, common) [Junior 9+ (2nd)]
Organic	(natural, clean, biological) [Expansion Set 2, Party Set]
Outrageous	(shocking, scandalous, disgraceful) [Basic Set, Party Set]
Overwhelming	(exhaustive, breathtaking, monumental) [Expansion Set 1, Party Set]
Painful	(hurtful, agonizing, unbearable) [Expansion Set 1, Party Set]
Painful	(hurting, sore) [Junior 9+ (1st) & (2nd)]
Pale	(faded, colorless) [Junior 9+ (2nd)]
Pathetic	(pitiful, distressing, heart-rending) [Expansion Set 2, Party Set]
Patriotic	(nationalistic, loyal, public-spirited) [Basic Set, Party Set]
Peaceful	(serene, restful, calm) [Expansion Set 1, Party Set]
Peaceful	(calm, quiet) [Junior 9+ (1st) & (2nd)]
Perfect	(faultless, consummate, exact) [Basic Set, Party Set]
Perfect	(ideal, wonderful) [Junior 9+ (2nd)]
Perverse	(stubborn, obstinate, improper) [Expansion Set 3, Party Expansion 1]
Philosophical	(thoughtful, contemplative, wise) [Expansion Set 1, Party Set]
Phony	(false, artificial, imitation) [Basic Set, Party Set]
Plain	(simple, evident, ordinary) [Basic Set (1999 Printing Only)]
Plain	(simple, dull) [Junior 9+ (1st) & (2nd)]
Plain & Simple	(unadorned, uncomplicated, clear) [Expansion Set 4, Party Expansion 1]
Playful	(fun, frisky, entertaining) [Expansion Set 1, Party Set]
Playful	(fun, cheerful) [Junior 9+ (1st) & (2nd)]
Pleasant	(enjoyable, nice) [Junior 9+ (2nd)]
Plug & Play	(effortless, automatic, self-operating) [Expansion Set 4, Party Expansion 1]
Plump & Tender	(ripe, chubby, fleshy) [Expansion Set 4, Party Expansion 1]
Polite	(respectful, well-mannered) [Junior 9+ (2nd)]
Poor	(not rich, unfortunate) [Junior 9+ (2nd)]
Popular	(well-liked, accepted, preferred) [Expansion Set 2, Party Set]
Powerful	(strong, forceful, robust) [Basic Set, Party Set]
Powerful	(strong, forceful) [Junior 9+ (1st) & (2nd)]
Practical	(useful, helpful) [Junior 9+ (2nd)]
Pretty	(lovely, attractive, good-looking) [Expansion Set 3, Party Expansion 1]
Pretty	(good-looking, pleasing) [Junior]
Prim & Proper	(reserved, modest, prudish) [Expansion Set 4, Party Expansion 1]
Primitive	(prehistoric, primal, uncivilized) [Basic Set, Party Set]
Principled	(conscientious, ethical, scrupulous) [Basic Set, Party Set]
Profound	(deep, wise, thoughtful) [Basic Set, Party Set]
Proud	(dignified, satisfied) [Junior 9+ (1st) & (2nd)]
Puffy	(swollen, billowy, bloated) [Expansion Set 2, Party Set]
Pure	(innocent, unadulterated, chaste) [Basic Set, Party Set]
Quick	(fast, speedy) [Junior 9+ (1st) & (2nd)]
Quick & Dirty	(cheap, shoddy, inferior) [Expansion Set 4, Party Expansion 1]
Quiet	(peaceful, silent, calm) [Expansion Set 2, Party Set]
Quiet	(silent, noiseless) [Junior]
Radiant	(shining, glowing, sparkling) [Expansion Set 1, Party Set]
Radical	(unconventional, revolutionary, extreme) [Basic Set, Party Set]
Rare	(scarce, unusual, half-cooked) [Expansion Set 1, Party Set]
Raw	(crude, uncooked, harsh) [Expansion Set 3, Party Expansion 1]
Realistic	(authentic, lifelike, reasonable) [Expansion Set 1, Party Set]
Refreshing	(brisk, invigorating, rejuvenating) [Expansion Set 1, Party Set]
Refined	(well-bred, purified, cultivated) [Expansion Set 2, Party Set]
Relaxed	(calm, not tense) [Junior 9+ (1st) & (2nd)]
Relaxing	(restful, calming, peaceful) [Expansion Set 2, Party Set]
Repulsive	(disgusting, offensive, foul) [Expansion Set 2, Party Set]
Respectable	(worthy, honorable, decent) [Expansion Set 3, Party Expansion 1]
Responsible	(accountable, obligated, mature) [Basic Set, Party Set]
Revolutionary	(innovative, rebellious, radical) [Expansion Set 1, Party Set]
Rich	(wealthy, affluent, moneyed) [Basic Set, Party Set]
Rich	(wealthy, not poor) [Junior 9+ (2nd)]
Ridiculous	(preposterous, absurd, ludicrous) [Basic Set, Party Set]
Risky	(hazardous, daring, speculative) [Expansion Set 1, Party Set]
Rough	(scratchy, uneven, jagged) [Basic Set, Party Set]
Rough	(not smooth, not gentle) [Junior]
Rough & Ready	(crude, makeshift, prepared) [Expansion Set 4, Party Expansion 1]
Round	(circular, ring shaped) [Junior 9+ (1st) & (2nd)]
Sad	(unhappy, gloomy) [Junior 9+ (1st) & (2nd)]
Saintly	(virtuous, angelic, divine) [Basic Set, Party Set]
Sappy	(gooey, mushy, romantic) [Basic Set, Party Set]
Scary	(frightening, absurd, ugly) [Basic Set, Party Set]
Scary	(frightening, spooky) [Junior 9+ (1st) & (2nd)]
Scenic	(picturesque, dramatic, panoramic) [Expansion Set 1, Party Set]
Scented	(perfumed, fragrant) [Junior 9+ (2nd)]
Secretive	(concealed, covert, veiled) [Expansion Set 3, Party Expansion 1]
Selfish	(stingy, greedy, miserly) [Basic Set, Party Set]
Sensational	(thrilling, startling, melodramatic) [Expansion Set 3, Party Expansion 1]
Senseless	(meaningless, absurd, foolish) [Expansion Set 2, Party Set]
Sensitive	(susceptible, sympathetic, tender) [Basic Set, Party Set]
Sensual	(tactile, pleasing, sexual) [Basic Set, Party Set]
Serious	(important, thoughtful) [Junior 9+ (1st) & (2nd)]
Sexy	(arousing, appealing, seductive) [Basic Set, Party Set]
Shaggy	(bushy, stringy) [Junior]
Shallow	(superficial, trivial, not deep) [Expansion Set 2, Party Set]
Sharp	(pointed, keen, acute) [Expansion Set 2, Party Set]
Sharp	(pointed, not rounded) [Junior]
Shiny	(reflective, gleaming, polished) [Expansion Set 1, Party Set]
Shiny	(bright, glossy) [Junior]
Shocking	(frightening, electrifying, startling) [Expansion Set 1, Party Set]
Short	(not long, not tall) [Junior]
Short & Stout	(plump, portly, tubby) [Expansion Set 4, Party Expansion 1]
Short & Sweet	(precise, clear-cut, succinct) [Expansion Set 4, Party Expansion 1]
Shy	(bashful, timid, cautious) [Expansion Set 1, Party Set]
Shy	(bashful, timid) [Junior 9+ (2nd)]
Sick & Tired	(worn out, exhausted, exasperated) [Expansion Set 4, Party Expansion 1]
Sick & Twisted	(depraved, wicked, lascivious) [Expansion Set 4, Party Expansion 1]
Sickening	(nauseating, disgusting, revolting) [Expansion Set 3, Party Expansion 1]
Sickening	(disgusting, horrible) [Junior 9+ (2nd)]
Silent	(quiet, still) [Junior 9+ (1st) & (2nd)]
Silky	(smooth, soft) [Junior 9+ (1st) & (2nd)]
Silly	(goofy, absurd, nonsensical) [Expansion Set 1, Party Set]
Silly	(foolish, goofy) [Junior]
Simple	(plain, easy) [Junior 9+ (1st) & (2nd)]
Skillful	(expert, talented) [Junior 9+ (1st) & (2nd)]
Skinny	(thin, lean) [Junior]
Slender	(slim, small) [Junior 9+ (2nd)]
Slimy	(slippery, gooey) [Junior 9+ (1st) & (2nd)]
Slippery	(slick, sliding) [Junior]
Sloppy	(messy, careless) [Junior]
Slow	(not fast, pokey) [Junior]
Slow & Steady	(reliable, deliberate, ponderous) [Expansion Set 4, Party Expansion 1]
Sluggish	(inactive, lazy, slothful) [Expansion Set 3, Party Expansion 1]
Small	(little, not large) [Junior]
Smart	(intelligent, stylish, witty) [Expansion Set 2, Party Set]
Smart	(intelligent, clever) [Junior 9+ (1st) & (2nd)]
Smelly	(stinky, odorous, rank) [Expansion Set 2, Party Set]
Smelly	(stinky, bad odor) [Junior 9+ (1st) & (2nd)]
Smooth	(even, level, flat) [Basic Set, Party Set]
Smooth	(not bumpy, flat) [Junior]
Smooth & Creamy	(silky, velvety, rich) [Expansion Set 4, Party Expansion 1]
Snappy	(stylish, trendy, fast) [Expansion Set 2, Party Set]
Sneaky	(tricky, mean) [Junior 9+ (2nd)]
Soft	(malleable, pliable, mushy) [Basic Set, Party Set]
Soft	(not hard, tender) [Junior]
Sophisticated	(urbane, cosmopolitan, complex) [Expansion Set 3, Party Expansion 1]
Sour	(bitter, tart) [Junior]
Special	(distinctive, unique, original) [Expansion Set 3, Party Expansion 1]
Special	(individual, unique) [Junior 9+ (2nd)]
Speedy	(quick, rapid, fast) [Basic Set, Party Set]
Speedy	(quick, fast) [Junior 9+ (2nd)]
Spic & Span	(spotless, tidy, clean) [Expansion Set 4, Party Expansion 1]
Spicy	(flavorable, tangy, hot) [Expansion Set 1, Party Set]
Spiritual	(religious, inspired, supernatural) [Expansion Set 1, Party Set]
Spooky	(scary, weird, ghostly) [Expansion Set 1, Party Set]
Spooky	(scary, frightening) [Junior]
Sporty	(athletic, active) [Junior 9+ (2nd)]
Spotless	(clean, pure) [Junior 9+ (2nd)]
Spunky	(perky, lively, spirited) [Expansion Set 1, Party Set]
Square	(rectangular, uncool, dull) [Expansion Set 1]
Squeaky Clean	(pure, immaculate, unapproachable) [Expansion Set 1, Party Set]
Stereotyped	(pigeonholed, caricatured, characterized) [Basic Set, Party Set]
Sticky	(gummy, pasty) [Junior 9+ (2nd)]
Stinky	(smelly, bad odor) [Junior]
Straight	(not curved, direct) [Junior 9+ (2nd)]
Strange	(odd, unusual) [Junior]
Strong	(powerful, forceful) [Junior]
Stunning	(astonishing, staggering, astounding) [Basic Set, Party Set]
Stupid	(ignorant, unintelligent, inane) [Expansion Set 3, Party Expansion 1]
Sultry	(sweltering, humid, sensual) [Expansion Set 2, Party Set]
Surprising	(unexpected, amazing) [Junior 9+ (2nd)]
Sweet	(sugary, caring, good) [Basic Set, Party Set]
Sweet	(sugary, nice) [Junior]
Swift	(quick, speedy, expeditious) [Basic Set, Party Set]
Swift & Sure	(steady, prompt, definite) [Expansion Set 4, Party Expansion 1]
Talented	(gifted, clever, skillful) [Basic Set, Party Set]
Talented	(skillful, gifted) [Junior 9+ (1st) & (2nd)]
Tall	(not short, not low) [Junior]
Tame	(subdued, gentle, trained) [Expansion Set 2, Party Set]
Tame	(not wild, mild) [Junior 9+ (1st) & (2nd)]
Tasty	(flavorful, savory, appetizing) [Expansion Set 3, Party Expansion 1]
Tasty	(flavorful, yummy) [Junior]
Technological	(scientific, futuristic, mechanical) [Expansion Set 1, Party Set]
Temperamental	(moody, irritable, short-tempered) [Basic Set, Party Set]
Tempting	(seductive, enticing, alluring) [Expansion Set 3, Party Expansion 1]
Tender	(soft, compassionate, fragile) [Expansion Set 3, Party Expansion 1]
Terrible	(awful, dreadful) [Junior 9+ (2nd)]
Terrific	(sensational, fabulous, severe) [Expansion Set 3, Party Expansion 1]
Thick	(wide, solid) [Junior 9+ (2nd)]
Thick & Chunky	(bulky, heavy, lumpy) [Expansion Set 4, Party Expansion 1]
Thin	(skinny, narrow) [Junior 9+ (1st) & (2nd)]
Thoughtful	(caring, unselfish) [Junior 9+ (2nd)]
Timeless	(classic, ageless, well-established) [Basic Set, Party Set]
Tiny	(little, very small) [Junior]
Tormenting	(torturing, harassing, agonizing) [Expansion Set 3, Party Expansion 1]
Torn & Tattered	(shabby, ragged, grungy) [Expansion Set 4, Party Expansion 1]
Touch & Go	(indecisive, uncertain, insecure) [Expansion Set 4, Party Expansion 1]
Touchy-Feely	(affectionate, tactile, huggy) [Basic Set, Party Set]
Tough	(strong, firm, difficult) [Expansion Set 1, Party Set]
Tough	(strong, hard) [Junior 9+ (1st) & (2nd)]
Trashy	(shameless, nasty, indecent) [Expansion Set 3, Party Expansion 1]
Tried & True	(tested, proven, trustworthy) [Expansion Set 4, Party Expansion 1]
True & Blue	(loyal, faithful, patriotic) [Expansion Set 4, Party Expansion 1]
Trustworthy	(honest, reliable, unfailing) [Basic Set, Party Set]
Trustworthy	(dependable, honest) [Junior 9+ (1st) & (2nd)]
Twisted	(distorted, warped, perverted) [Expansion Set 2, Party Set]
Ugly	(not pretty, unpleasant) [Junior]
Unbelievable	(incredible, far-fetched, impossible) [Party Set]
Unforgettable	(notable, impressive, remarkable) [Basic Set, Party Set]
Unforgettable	(memorable, treasured) [Junior 9+ (2nd)]
Unhappy	(sad, sorrowful) [Junior 9+ (1st) & (2nd)]
Unhealthy	(risky, sickly, dangerous) [Expansion Set 2, Party Set]
Unnatural	(abnormal, artificial, bizarre) [Expansion Set 2, Party Set]
Unreal	(imaginary, illusionary, unbelievable) [Expansion Set 2, Party Set]
Unscrupulous	(unethical, corrupt, unprincipled) [Basic Set, Party Set]
Unusual	(rare, odd, uncommon) [Expansion Set 2, Party Set]
Untamed	(wild, natural) [Junior 9+ (2nd)]
Up & Coming	(promising, enterprising, gifted) [Expansion Set 4, Party Expansion 1]
Up & Down	(volatile, variable, vertical) [Expansion Set 4, Party Expansion 1]
Useful	(helpful, handy) [Junior]
Useless	(worthless, ineffective, unneeded) [Expansion Set 1, Party Set]
Useless	(worthless, not valuable) [Junior 9+ (1st) & (2nd)]
Vain	(conceited, arrogant, fruitless) [Expansion Set 3, Party Expansion 1]
Valuable	(expensive, important) [Junior 9+ (2nd)]
Violent	(furious, vicious, destructive) [Expansion Set 1, Party Set]
Virtuous	(worthy, righteous, chaste) [Expansion Set 2, Party Set]
Visionary	(idealistic, prophetic, far-seeing) [Basic Set, Party Set]
Warm	(tepid, mild, affectionate) [Expansion Set 2]
Warm	(heated, somewhat hot) [Junior]
Warm & Cozy	(snug, comfy, friendly) [Expansion Set 4, Party Expansion 1]
Warm & Fuzzy	(kindhearted, loving, affectionate) [Expansion Set 4, Party Expansion 1]
Wash & Wear	(durable, easy-care, sturdy) [Expansion Set 4, Party Expansion 1]
Weak	(not strong, sickly) [Junior 9+ (1st) & (2nd)]
Weird	(abnormal, peculiar, odd) [Expansion Set 1, Party Set]
Weird	(odd, mysterious) [Junior]
Wet	(watery, soaked) [Junior]
Whimsical	(humourous, peculiar, fanciful) [Expansion Set 3, Party Expansion 1]
Wicked	(evil, corrupt, depraved) [Basic Set, Party Set]
Wide	(broad, thick) [Junior 9+ (2nd)]
Wild	(untamed, savage, ferocious) [Basic Set, Party Set]
Wild	(not tame, crazy) [Junior]
Wild & Wooly	(untamed, uncontrolled, reckless) [Expansion Set 4, Party Expansion 1]
Wired	(strained, tense, nervous) [Expansion Set 3, Party Expansion 1]
Witty	(clever, humorous, cunning) [Expansion Set 1, Party Set]
Woebegone	(dismal, sorrowful, bummed out) [Expansion Set 1, Party Set]
Wonderful	(great, excellent) [Junior]
Worldly	(experienced, sophisticated, materialistic) [Expansion Set 1, Party Set]
Worthless	(useless, meaningless) [Junior 9+ (2nd)]
Young	(not old, new) [Junior 9+ (1st) & (2nd)]
Young & Restless	(fidgety, impatient, flighty) [Expansion Set 4, Party Expansion 1]
Yucky	(icky, sickening) [Junior]
Zany	(crazy, funny, wacky) [Basic Set, Party Set]
