A Bad Haircut	The perfect start to a bad hair day. [Core Expansion 1, Party Box]
A Bakery	Some bakers start work at 3:00 in the morning, so breads and donuts are fresh for breakfast. [Junior Set (1st) & (2nd)]
A Broken Leg	I was riding my bike when I hit this big rock . . . [Junior Set (1st) & (2nd)]
A Bull Fight	Also known as "la fiesta brava" (the brave festival). A whole lot of bull.. [Core Expansion 2, Party Box]
A Cabin In The Woods	Henry David Thoreau went to Walden Pond for two years. All we're asking for is one lousy weekend! [Core Expansion 3, Party Box Expansion 1]
A Can Of Worms	Now you've opened it. [Core Expansion 3, Party Box Expansion 1]
A Car Crash	"Hey, it was an accident!" [Core Set, Party Box]
A Cheap Motel	No charge for the cockroaches. [Core Set, Party Box]
A Cookbook	The best ones include favorite family recipes. [Junior Set (2nd)]
A Crawl Space	Where you'll find something the cat dragged in. [Core Set, Party Box]
A Crown	A crown is a symbol of royalty. [Junior Set (2nd)]
A Desert	Hot, dry and sandy. [Junior Set (1st) & (2nd)]
A Dollar	Spend it wisely! [Junior Set (2nd)]
A Dozen Red Roses	When eleven just won't do. [Core Expansion 1, Party Box]
A Fairy	A tiny creature who has magical powers and can fly, like Tinkerbell. [Kids Set]
A Few Good Men	Is that too much to ask? [Core Expansion 3, Party Box Expansion 1]
A Flat Tire	"Whaddya mean, there's no spare?" [Core Set, Party Box]
A Fool & His Money	Are soon parted... especially on Wall Street. [Core Expansion 4, Party Box Expansion 1]
A Forest	Home to Bambi, Winnie the Pooh, Robin Hood, and many woodland animals. [Kids Set]
A French Maid	Ooh, la, la! [Core Expansion 3, Party Box Expansion 1]
A Full Moon	"When the moon hits your eye like a big pizza pie, that's amore!" -Dean Martin [Core Expansion 1, Party Box]
A Funeral	A ceremony held to honor a person who has died. [Junior Set (1st) & (2nd)]
A Giant	A very large and powerful person. When Jack climbed the bean stalk, he met a hungry giant. [Kids Set]
A Haunted House	Maybe if people would STOP building their dream homes on ancient burial grounds ... [Core Expansion 1, Party Box]
A High School Bathroom	"Fools rush in where angels fear to tread" -Alexander Pope [Core Set, Party Box]
A Hole In One	Par for the course? [Core Expansion 3, Party Box Expansion 1]
A Honeymoon	America's top honeymoon spots are Hawaii, Niagara Falls, Las Vegas and Florida. You can get there by air, land, sea ... or shotgun. [Core Set, Party Box]
A King	King Arthur became famous when he pulled a magical sword from a stone. [Kids Set]
A Leaky Boat	Time to bail out. [Junior Set (2nd)]
A Little White Lie	If you can't say anything nice . . . [Core Expansion 3, Party Box Expansion 1]
A Locker Room	Steamy atmosphere ... bawdy humor ... sweaty bodies ... HEY! Sounds like Cable TV! [Core Set, Party Box]
A Log Cabin	Just cut down a few trees and make a house. [Junior Set (2nd)]
A Mermaid	An imaginary creature with the upper body of a woman and the tail of a fish. [Junior Set (2nd)]
A Microwave Oven	You'll have popcorn in two minutes. [Junior Set (2nd)]
A Million Dollars	If I had a million dollars. . . [Core Expansion 3, Party Box Expansion 1]
A Morgue	"Given strange eons, even death may die..." -H.P. Lovecraft [Core Set, Party Box]
A Movie Theater	When you want a REALLY big screen. [Junior Set (2nd)]
A Mummy	"Walk like an Egyptian." - The Bangles [Core Expansion 3, Party Box Expansion 1]
A Mummy	In Egypt there are mummies that are over 3,000 years old. [Junior Set (2nd)]
A Nine Iron	A golf club best used on short shots or large opponents. [Core Expansion 2, Party Box]
A Parade	I love a parade. [Junior Set (2nd)]
A Piano	A piano is a percussion instrument, like a drum or cymbal. [Junior Set (2nd)]
A Pile Of Leaves	Rake them up and jump in! [Kids Set]
A Prince	Some are real, but most are just in fairy tales. [Junior Set (2nd)]
A Princess	Some are real, but most are just in fairy tales. [Junior Set (2nd)]
A Queen	A wicked queen tried to kill Snow White with a poison apple. [Kids Set]
A Refrigerator	First stop after school. [Junior Set (2nd)]
A Ringing In My Ears	Answer that, would'ya? [Core Expansion 3, Party Box Expansion 1]
A Saw	A metal tool with sharp teeth used to cut metal and wood. Some are used as musical instruments. [Kids Set]
A School Bus	The only thing we have to fear is fear itself. -Franklin D. Roosevelt [Core Expansion 1, Party Box]
A School Cafeteria	Food fight!. [Core Expansion 2, Party Box]
A School Dance	No chicken dance or hokey-pokey! [Junior Set (1st) & (2nd)]
A Spare Tire	The good news is: we have a spare tire . . . [Core Expansion 3, Party Box Expansion 1]
A Submarine	It's a sandwich shaped like a boat.or a boat shaped like a sandwich. [Junior Set (2nd)]
A Sunrise	"But he who kisses the joy as it flies/ Lives in eternity's sunrise." -William Blake [Core Set, Party Box]
A Sunset	The sun never set on the British Empire ... because God didn't trust the English in the dark. [Core Set, Party Box]
A Surprise	Something that is unexpected, like a present from a friend. [Kids Set]
A Swimming Pool	No diving in the shallow end. [Junior Set (1st) & (2nd)]
A Tree House	Your first high-rise apartment. [Core Expansion 1, Party Box]
A Used Car Lot	One of the most honest places around. Honest ... [Core Set, Party Box]
A Volcano	Hot lava! [Junior Set (1st) & (2nd)]
Abbot & Costello	Comedy team who had everyone guessing - "Who's on first?" [Core Expansion 4, Party Box Expansion 1]
Abraham Lincoln	1809-65, 16th U.S. president, led the Union to victory in the American Civil War and abolished slavery. Was assassinated for his efforts. [Core Set, Party Box]
Abraham Lincoln	President of the U.S. during the Civil War. He was called "Honest Abe." [Junior Set (1st) & (2nd)]
Actors	If they're really good, you can't tell they're acting. [Junior Set (2nd)]
Actresses	"Romeo, Romeo, wherefore art thou." Romeo and Juliet by William Shakespeare. [Junior Set (2nd)]
Adam & Eve	A relationship of Biblical proportions. [Core Expansion 4, Party Box Expansion 1]
Adam Sandler	1966- , American comedian, film star, and Saturday Night Live alumnus. Genius or goofball - you make the call. [Core Expansion 2, Party Box]
Adolph Hitler	1889-1945, turned Germany into a militarized dictatorship, caused the slaughter of millions and launched World War II. [Core Set, Party Box]
Africa	The continent located between the Atlantic Ocean and Indian Ocean. [Junior Set (1st) & (2nd)]
AIDS	Acquired Immune Deficiency Syndrome. [Core Expansion 2, Party Box]
Airline Food	Since when is a bag of peanuts considered a meal? [Core Expansion 1, Party Box]
Airplane	The Wright Brothers were "wright" when they added power to a glider in order to make it fly. [Junior Set (2nd)]
Airplanes	I want to sit by the window! [Kids Set]
Al Pacino	1940- , Oscar winning American actor and star of "The Godfather," "Dog Day Afternoon" and "Scent Of A Woman." One very intense guy. [Core Expansion 1, Party Box]
Aladdin	Folktale character who found a magic lamp with a gentle genie inside. [Kids Set]
Alan Greenspan	1926-, chairman of the U.S. Federal Reserve Board. [Core Expansion 3, Party Box Expansion 1]
Alaska	The 49th state. It's the home of Mount McKinley. [Junior Set (2nd)]
Albert Einstein	1879-1855, German-born American physicist and Nobel laureate who created theories of relativity. Nice hair. [Core Set, Party Box]
Alfred Hitchcock	1899-1980, British-born American director and producer of brilliant psychological thrillers. Right, mother? MOTHER! [Core Set, Party Box]
Alien Abductions	There was a blinding light -and she was gone! [Core Expansion 1, Party Box]
Aliens	They're not from around here! [Junior Set (1st) & (2nd)]
Alligators	Large reptiles with strong jaws and long tails. Their skins are made into shoes and purses. [Junior Set (1st) & (2nd)]
AM & FM	Making waves in radio. [Core Expansion 4, Party Box Expansion 1]
Americans	How many Americans does it take to screw in a light bulb? THAT'S NOT FUNNY! WE'RE SUING! [Core Set, Party Box]
Amputations	"A SCRATCH? Your arm's off!" - Monty Python and the Holy Grail. [Core Expansion 2, Party Box]
Amsterdam	The capital of the Netherlands, and one of Europe's most beautiful and notorious cities. [Core Expansion 3, Party Box Expansion 1]
An Igloo	A domed-shaped house made from blocks of hard snow or ice. [Kids Set]
Ancient Rome	In ancient times, all roads led to Rome, and the traffic has only gotten worse. [Core Expansion 3, Party Box Expansion 1]
Andy Warhol	1928-87, American painter and filmmaker, a leader of the pop art movement. Famous for slightly more than 15 minutes. [Core Set, Party Box]
Angry Hornets	Who put the bees in their bonnets?. [Core Expansion 2, Party Box]
Anna & The King	The 1999 film romanticizing the story of Anna Leonowens and King Mongkut of Siam. [Core Expansion 4, Party Box Expansion 1]
Anna Kournikova	1981-, Russian-born star of the tennis court and internet. [Core Expansion 3, Party Box Expansion 1]
Anne Frank	1929-45, German Jewish girl who wrote in her diary about her family hiding from the Nazis. She died in a concentration camp. [Core Set, Party Box]
Antarctica	Home to the lowest Junior Seterature ever recorded on earth, -126.9 F. [Core Set, Party Box]
Anthony Hopkins	1937- , British actor starred in The Elephant Man, Howard's End, and, of course, The Silence Of The Lambs. Knighted in 1992. [Core Expansion 2, Party Box]
Anthrax	A potentially deadly infectious disease caused by spore bacteria. Anthrax has been developed as a biological weapon. [Core Expansion 3, Party Box Expansion 1]
Antiques Roadshow	PBS television program where folks bring oddities for appraisal. One person's trash is another one's treasure. [Core Expansion 3, Party Box Expansion 1]
Antony & Cleopatra	Roman general and Egyptian queen. A love affair that wouldn't die. Oh, wait, it did. [Core Expansion 4, Party Box Expansion 1]
Ants	Some are black and some are red. I don't want them in my bed! [Kids Set]
Apple Juice	Baby's first juice. [Kids Set]
Apple Pie	It's as American as ... as ... something ... [Core Expansion 1, Party Box]
Apples	More than 40 million metric tons are produced worldwide every year. How 'bout them apples? [Core Set, Party Box]
Apples	Johnny Appleseed traveled across the United States planting seeds for apple trees. [Kids Set]
Apples & Oranges	Don't even TRY to compare them. [Core Expansion 4, Party Box Expansion 1]
Aristotle	384-322 B.C., ancient Greek philosopher. His writings formed the foundation for much of today's philosophical and political thought. [Core Expansion 3, Party Box Expansion 1]
Arm & A Leg	Sure, they were free, but just try replacing them. [Core Expansion 4, Party Box Expansion 1]
Armadillo	Burrowing mammal with armor-like bony plat covering. Roadkill extraordinaire. [Core Expansion 3, Party Box Expansion 1]
Armed Robbery	You got your Robbery, your Armed Robbery, your Strong Armed Robbery, and, of course, the five finger discount. [Core Expansion 2, Party Box]
Arnold Schwarzenegger	1947-, Austrian born body-builder turned actor. "My body is like breakfast, lunch, and dinner. I don't think about it, I just have it." [Core Expansion 3, Party Box Expansion 1]
Aroma Therapy	Alternative medicine. Something's smelly about it. [Core Expansion 3, Party Box Expansion 1]
Arsenic & Old Lace	The hilarious dark comedy written by Joseph Kesselring, or the 1944 film adaptation by Frank Capra. [Core Expansion 4, Party Box Expansion 1]
Artists	So creative! [Junior Set (1st) & (2nd)]
Assault & Battery	That would be a single "A" battery. [Core Expansion 4, Party Box Expansion 1]
Assembly Lines	Faster. FASTER! [Core Expansion 2, Party Box]
Astronauts	It's a great day for a space walk! [Junior Set (2nd)]
At My Parent's House	Like never-never land, you're never seen as an adult here. [Core Set, Party Box]
Atlantis	Mythological city where the folks had that sinking feeling. [Core Expansion 2, Party Box]
Atomic Bombs	The Italian physicist Enrico Fermi succeeded in producing the first nuclear chain reaction in 1942, at the University of Chicago. [Core Set, Party Box]
Attack On Pearl Harbor	"Yesterday, December 7th, 1941, a date which will live in infamy ..." -Franklin D. Roosevelt [Core Set, Party Box]
Austin Powers	Fictional British man of mystery. Yeah, bay-beee, yeah! [Core Expansion 1, Party Box]
Australian Outback	Beware of dangerous Junior Seteratures, strange animals, and didgeridoos. [Core Expansion 1, Party Box]
Babe Ruth	1895-1948, American baseball legend, and one heck of a candy bar! [Core Set, Party Box]
Babies	Little bundles of joy ... and who needs sleep, anyway? [Core Expansion 2, Party Box]
Babies	Very young children or infants. They cry a lot! [Kids Set]
Baby Dolls	Some of them talk, some of them walk, and some even wet their pants! [Kids Set]
Baby Food	Strained peas and mushy meat. Doesn't that sound good? [Junior Set (1st) & (2nd)]
Baby Showers	Baby showers may bring flowers ... [Core Set, Party Box]
Babysitters	The good ones let you stay up late. [Kids Set]
Backstreet Boys	The latest American pop boy band. Which one do you think is the cutest? [Core Expansion 1, Party Box]
Backyards	Your playground at home! [Junior Set (1st) & (2nd)]
Bacon	Meat from a pig, flavored with salt and smoke. Oink! [Junior Set (1st) & (2nd)]
Bad Dogs	Bad dog, bad dog. What'cha gonna do? [Core Set, Party Box]
Bad Dreams	Like good dreams, but with monsters. [Kids Set]
Bagels And Lox	A perfect snack for salmon-chanted evening ... [Core Expansion 3, Party Box Expansion 1]
Bagpipes	A shrill-toned musical instrument consisting of a leather bag and pipes. Also available in plaid. [Core Expansion 1, Party Box]
Baked Beans	Add a little bacon, brown sugar and Beano! [Core Expansion 2, Party Box]
Baked Potatoes	Hot potato, couch potato, potato head, twice baked, half-baked, ... whatever. [Core Set, Party Box]
Baking Cookies	An experience only surpassed by eating them. [Core Expansion 1, Party Box]
Baking Cookies	Mix up the dough and put them in the oven. [Kids Set]
Bald Eagles	Known for their majestic appearance and powerful flight. In 1782, the bald eagle was chosen as the emblem of the United States. [Core Expansion 1, Party Box]
Bald Eagles	They're not really bald. The white feathers on their heads make them look that way. [Junior Set (1st) & (2nd)]
Ball & Chain	Don't let it get you down. [Core Expansion 4, Party Box Expansion 1]
Ballerinas	Beautiful, graceful dancers who are always on their toes. [Core Expansion 1, Party Box]
Ballerinas	It takes years of training before a ballerina can dance in toe shoes. [Junior Set (1st) & (2nd)]
Balloons	Lots of colors, shapes, and sizes. [Kids Set]
Ballroom Dancing	Fox-trots, tangos, cha-chas, and more! Are you ready to rumba? [Core Expansion 3, Party Box Expansion 1]
Bananas	Monkeys like them a bunch! [Kids Set]
Band-Aids	Available in lots of colors and shapes. A fun way to cover cuts and scrapes. [Junior Set (1st) & (2nd)]
Bangkok	Capital of Thailand. Location: near the Gulf of Siam. Population: five million. Reputation: seedy. [Core Set, Party Box]
Bankruptcy	It'll be the debt of you. [Core Expansion 2, Party Box]
Barbara Walters	1931- , American television journalist and author. Voted one of the most important women of the century by "Ladies Home Journal." [Core Expansion 1, Party Box]
Barbed Wire	Wire with sharp points, used for fences. Created havoc on the western frontier. [Core Expansion 1, Party Box]
Barbershops	It's a beauty shop for guys. [Junior Set (2nd)]
Barbie & Ken	Ah, to be blond and plastic... [Core Expansion 4, Party Box Expansion 1]
Barbie Dolls	Tall, thin, fashion dolls with lots of clothes and tiny feet. [Kids Set]
Barfing	We didn't want to bring that up ... [Core Set, Party Box]
Barney	Purple dinosaur. "I love you, you love me, blah, blah, blah ... " [Core Set, Party Box]
Barney	A large, purple dinosaur. "I love you, you love me." [Kids Set]
Bart Simpson	Fictional animated character. Don't have a cow, man!" [Core Set, Party Box]
Baseball	Its one, two, three strikes you're out . . . [Core Expansion 3, Party Box Expansion 1]
Baseball Games	"One, two, three strikes, YOU'RE OUT!" [Junior Set (1st) & (2nd)]
Baseball Fields	It's 90 feet from home plate to first base. But it seems longer when you're trying to reach it! [Junior Set (2nd)]
Basketball	Some basketball players are over seven feet tall. [Junior Set (1st) & (2nd)]
Bates Motel	The haunt of Alfred Hitchcock's psycho, Norman Bates ... and mother, of course ... [Core Expansion 2, Party Box]
Batman	How does Batman's mother call him home? "Dinner, dinner, dinner, dinner, dinner, dinner, dinner, dinner - BATMAN!" [Core Expansion 2, Party Box]
Batman	A superhero who wears a black mask and cape. He drives the Batmobile. [Kids Set]
Batman & Robin	Superheroes or vigilantes, you make the call. [Core Expansion 4, Party Box Expansion 1]
Bats	The little brown bat consumes as many as 600 mosquitoes in an hour. The vampire bat dines elsewhere ... [Core Expansion 1, Party Box]
Bats	Either furry little animals that fly, or sticks used to hit baseballs. [Kids Set]
Bats & Balls	At least they don't go on strike. [Core Expansion 4, Party Box Expansion 1]
BB Guns	You'll shoot your eye out!" [Core Expansion 3, Party Box Expansion 1]
Beach Balls	Blow them up and watch them blow away! [Junior Set (1st) & (2nd)]
Beach Parties	Up for some "Beach Blanket Bingo," Annette? [Core Expansion 1, Party Box]
Beanbag Chairs	For beanbag butts . . . [Core Expansion 3, Party Box Expansion 1]
Beanie Babies	Tiny plush collectible to love and cherish. Don't take that tag off! [Core Expansion 1, Party Box]
Beanie Babies	Little bean bag creatures that can be played with or collected. [Kids Set]
Bears	Large, shaggy animals with sharp claws and little tails. Sometimes they are named Teddy. [Kids Set]
Beauty & The Beast	A French fairy tale, animated by Disney in 1991. [Core Expansion 4, Party Box Expansion 1]
Beauty And The Beast	A tale as old as time ... so Disney didn't have to pay royalties. [Core Expansion 2, Party Box]
Beavis & Butt-Head	He said "butt." Huh-huh. Huh-huh. [Core Expansion 4, Party Box Expansion 1]
Bed & Breakfast	Not the same as breakfast in bed. [Core Expansion 4, Party Box Expansion 1]
Bee Stings	Leave the bees alone- and they'll leave you alone. [Junior Set (2nd)]
Beef Stew	Meat, potatoes, carrots, onions... [Junior Set (2nd)]
Beer	"Beer is proof that God loves us and wants us to be happy." - Benjamin Franklin [Core Expansion 2, Party Box]
Beer & Pretzels	"these pretzels are making me thirsty" - Cosmo Kramer, Seinfeld [Core Expansion 4, Party Box Expansion 1]
Beer Bellies	Just think of them as microbreweries. [Core Expansion 1, Party Box]
Beethoven	1770-1827, German composer, considered one of the greatest of the western world. [Core Set, Party Box]
Beets	Beats Brussels sprout. [Core Expansion 2, Party Box]
Beets	Round purplish-red vegetables. Do you like beets? [Kids Set]
Being & Nothingness	Jean Paul Satre's 1943 work based on the distinction between things that exist by themselves and those that exist for themselves. [Core Expansion 4, Party Box Expansion 1]
Being In Love	"Love's like the measles, all the worse when it comes late." -Douglas Jerrold [Core Set, Party Box]
Bell-Bottoms	Bell-bottoms and pea coats -who would have thought the Navy could be such a trendsetter? [Core Expansion 1, Party Box]
Bells & Whistles	It's got everything! [Core Expansion 4, Party Box Expansion 1]
Belt Buckles	Cowboys like them fancy and pilgrims like them plain. [Junior Set (2nd)]
Ben Stiller	1965-, American actor, director, and funny guy of Reality Bites, There's Something About Mary, and Meet The Parents [Core Expansion 2, Party Box]
Berlin	1945 - Adolph Hitler's last stand. Bunker ... I mean -hunker down, soldier. [Core Set, Party Box]
Bert & Ernie	Sesame Street's muppet buddies. [Core Expansion 4, Party Box Expansion 1]
Bert And Ernie	Two nice guys in striped shirts who live on Sesame Street. [Kids Set]
Bigfoot	Legendary North American monster, a.k.a. Sasquatch or the Abominable Snowman. [Core Expansion 1, Party Box]
Big Bang Theory	A cosmological theory for the origin of the universe. An explosive idea! [Core Expansion 2, Party Box]
Big Bird	Beloved Sesame Street character, or the not-necessarily-beloved U.S. spy satellite. [Core Expansion 3, Party Box Expansion 1]
Big Bird	A very large, yellow bird who lives on Sesame Street with Bert and Ernie. [Kids Set]
Big Cities	Very large towns, like New York, Los Angeles and Chicago. [Kids Set]
Big Dogs	An adult Saint Bernard weighs over 170 pounds. [Junior Set (1st) & (2nd)]
Big Macs	T w o a l l b e e f p a t t i e s s p e c i a l s a u c e l e t t u c e c h e e s e p i c k l e s o n i o n s o n a s e s a m e s e e d b u n . [Core Expansion 2, Party Box]
Bill & Ted	Characters in Keanu Reeves' excellent time-travel adventure film. Yeah, dude. [Core Expansion 4, Party Box Expansion 1]
Bill Clinton	1946- , popular, yet embattled, 42nd president of the United States. [Core Set, Party Box]
Bill Gates	1955-, chairman and chief software architect of Microsoft Corporation. A very rich guy. [Core Set, Party Box]
Bill Murray	1950-, American actor and comedian. Star of Ghostbusters, Stripes, Groundhog Day, and Lost In Translation. [Core Expansion 2, Party Box]
Billboards	Only 1,254 miles to Wall Drug ... [Core Set, Party Box]
Billy Crystal	1947-, American comedian, actor and director. He looks maaaaah-velous. [Core Expansion 3, Party Box Expansion 1]
Bingo	"There was a farmer, had a dog, and Bingo was his name-o ..." [Core Expansion 2, Party Box]
Bingo	Get five in a row. BINGO! [Junior Set (2nd)]
Bird Watching	A hobby that relies on a wing and a prayer. [Core Expansion 1, Party Box]
Birds	"Birds of a feather, flock together." [Kids Set]
Birthday Cake	What kind of cake, white or chocolate? [Kids Set]
Black Cats	It's bad luck if they cross your path. You might step in a hairball! [Core Expansion 3, Party Box Expansion 1]
Black Cats	They're not really bad luck! [Junior Set (2nd)]
Black Holes	The gravitational field of a black hole is so strong that nothing, including light, can escape from its vicinity. [Core Set, Party Box]
Black Licorice	Alexander the Great and Julius Caesar both endorsed the beneficial properties of Licorice. No word on black jelly beans . . . [Core Expansion 3, Party Box Expansion 1]
Black Lingerie	Victoria's REAL secret: selling skimpy negligees at hefty price . . . [Core Expansion 3, Party Box Expansion 1]
Black Velvet	Smooth, silky and sophisticated ... until you paint an Elvis on it. [Core Expansion 2, Party Box]
Blackouts	They can occur at any [Core Expansion 3, Party Box Expansion 1]
Blizzard	Extreme cold, strong winds, and a head snowfall. Also known as Canada. [Core Set, Party Box]
Blood	A healthy human body contains between five and six quarts of blood. Bloody right they do! [Core Set, Party Box]
Blood	Blood carries oxygen and nutrients throughout the body. [Junior Set (2nd)]
Blood & Tears	Don't forget the sweat. [Core Expansion 4, Party Box Expansion 1]
Blowing Bubbles	The bigger the better! [Kids Set]
Blowing Your Nose	Please use a tissue! [Kids Set]
Blue Velvet	An elegant, textured fabric, Bobby Vinton love song, or David Lynch's bizarre 1986 film about the dark side of small-town America. [Core Expansion 3, Party Box Expansion 1]
Blueberries	Blueberries will stain your teeth. Smile! [Junior Set (1st) & (2nd)]
Board Games	Games have been played for thousands of years. Some games of Monopoly just SEEM that long. [Core Expansion 2, Party Box]
Boardwalk & Park Place	Top of the line in the real estate game. [Core Expansion 4, Party Box Expansion 1]
Boats	"Row, row, row your boat!" [Kids Set]
Body & Soul	Just tryin' to keep it all together. [Core Expansion 4, Party Box Expansion 1]
Body Odor	Over $1.6 billion is spent each year on antiperspirants in the United States. That stinks! [Core Expansion 2, Party Box]
Body Piercing	YOU STUCK WHAT? WHERE? [Core Expansion 2, Party Box]
Body Snatchers	We'd be worried, but nobody would want to snatch OUR bodies . . . [Core Expansion 3, Party Box Expansion 1]
Body Surfing	When you're too cheap to buy a surfboard. [Core Set, Party Box]
Bodybuilders	If you build it they will come. [Core Expansion 3, Party Box Expansion 1]
Bonbons	Sweets for the sweet ... [Core Set, Party Box]
Bongos	Small drums played with the fingers. Used in Latin American and African music. The choice of American beat poets. [Core Expansion 1, Party Box]
Bonnie & Clyde	American outlaws of the 1920s, played by Faye Dunaway and Warren Beatty in the 1967 film. [Core Expansion 4, Party Box Expansion 1]
Bora Bora	Volcanic island in the Pacific. Good oranges and vanilla. [Core Expansion 3, Party Box Expansion 1]
Bottled Water	How much are you willing to pay for something you can get for free? [Core Expansion 2, Party Box]
Bow & Arrows	More effective than sticks and stones. [Core Expansion 4, Party Box Expansion 1]
Bowling	Three strikes and you're in. [Core Expansion 3, Party Box Expansion 1]
Bowling	A game played by rolling a heavy ball so that it knocks down wooden pins. A perfect score is 300. [Junior Set (1st) & (2nd)]
Boxing	An ancient and honorable sport - not just for boys anymore ... [Core Expansion 2, Party Box]
Boy Scouts	International organization for boys and young men founded in England in 1908, to foster character, citizenship and outdoor life. [Core Expansion 2, Party Box]
Boy Scouts	On my honor, I will do my best... and learn to camp. [Junior Set (2nd)]
Boyfriends	"My boyfriend's back and you're gonna be in trouble." - The Angels [Core Expansion 2, Party Box]
Boyfriends	We're just friends! [Junior Set (2nd)]
Boys	"Snips and snails and puppy dog tails." [Kids Set]
Braces	No more gum, no caramels, no corn on the cob. [Junior Set (1st) & (2nd)]
Brad Pitt	1963- , American actor and heart-throb. [Core Set, Party Box]
Brain Surgeons	Hey, it ain't brain surgery ... oh ... wait a second ... [Core Expansion 1, Party Box]
Brains	Vital to human existence and mad scientists. [Core Expansion 2, Party Box]
Brains	It's all in your head. [Junior Set (1st) & (2nd)]
Bread & Water	Make that a baguette and a bottle of Perrier. [Core Expansion 4, Party Box Expansion 1]
Breaking & Entering	"Honest, Officer, I lost my keys." [Core Expansion 4, Party Box Expansion 1]
Bride & Groom	"With this ring..." [Core Expansion 4, Party Box Expansion 1]
Britney Spears	1981-, American singer. From mouseketeer to international pop star. [Core Expansion 1, Party Box]
Broadway	The New York theater district. "They say the neon lights shine bright on Broadway." -Barry Mann [Core Expansion 2, Party Box]
Brooks & Dunn	Extremely successful country & honky-tonk music duo. "If they don't dance, you're dead." - Ronnie Dunn [Core Expansion 4, Party Box Expansion 1]
Brothers	Oh, brother! [Junior Set (1st) & (2nd)]
Brothers & Sisters	"You can pick your friends, but..." [Core Expansion 4, Party Box Expansion 1]
Bruce Willis	1955- , Diehard American action movie star who has moonlighted on TV. He also starred in Pulp Fiction, Armageddon and The Sixth Sense. [Core Expansion 2, Party Box]
Bruises	The dark color of a bruise is caused by broken blood vessels under the skin. [Junior Set (2nd)]
Brushing Your Teeth	Oh! What's that gunk stuck on your teeth? [Junior Set (1st) & (2nd)]
Bubble Bath	Just add water! [Junior Set (2nd)]
Bubble Gum	Crack it, snap it, pop it, and blow it! [Core Expansion 2, Party Box]
Bubble Gum	Chewing is easy, blowing bubbles is hard, getting it out of your hair is even harder. [Junior Set (1st) & (2nd)]
Bubbles	"Tiny bubbles, in the wine/ Tiny bubble make me feel fine ..." -Don Ho [Core Set, Party Box]
Buddies	Good friends - people and pets. [Kids Set]
Buffalo	A large animal with a big, shaggy head and a hump on its back, native to North America. [Junior Set (1st) & (2nd)]
Bugs	Ants, beetles, spiders, and roaches. It's "A Bug's Life." [Kids Set]
Bugs Bunny	A tall, skinny cartoon rabbit. "What's up, Doc?" [Kids Set]
Bulls & Bears	On or off Wall Street. [Core Expansion 4, Party Box Expansion 1]
Bullfighting	A traditional sport in some Spanish speaking countries. [Junior Set (2nd)]
Bullwinkle	As in the cartoon "The Adventures of Rocky and Bullwinkle" - the moose half of moose and squirrel. [Core Expansion 1, Party Box]
Bumble Bees	Large, fuzzy bees with yellow and black stripes. Watch out - they sting! [Kids Set]
Bumper Cars	Much like rush hour in Chicago. [Core Expansion 3, Party Box Expansion 1]
Bumper Stickers	Your personal billboard! [Core Expansion 1, Party Box]
Bungee Jumping	Another sport hanging on by a thread. [Core Set, Party Box]
Bunk Beds	Two single beds, one on top of the other. I want the top! [Junior Set (1st) & (2nd)]
Burger & Fries	You want flies with that?" [Core Expansion 4, Party Box Expansion 1]
Burned Toast	Want some burned bacon with that? [Junior Set (1st) & (2nd)]
Bus Drivers	Don't bother the bus driver. [Junior Set (1st) & (2nd)]
Butter	What's better than butter? [Junior Set (1st) & (2nd)]
Buttons & Bows	Cute as a button, or a bow. [Core Expansion 4, Party Box Expansion 1]
Butterflies	Butterflies flutter by. [Junior Set (1st) & (2nd)]
Buying A House	If only we had the money, we could get a mortgage. [Core Expansion 1, Party Box]
Buzz Lightyear	The animated star of Toy Story. "To infinity and beyond!" [Junior Set (2nd)]
Cabbage	From the French word caboche, meaning "big head." [Core Expansion 2, Party Box]
Cactus	Require little care and exhibit bizarre forms. As such, they are often mistaken for Survivalists. [Core Set, Party Box]
California	Sacramento is its capital, Los Angeles its largest city. Here we come. [Core Set, Party Box]
Calvin & Hobbs	Bill Waterson's late, great comic strip featuring a little boy and his tiger. [Core Expansion 4, Party Box Expansion 1]
Camelot	"On second though, let's not go to Camelot. 'Tis a silly place." - King Arthur, Monty Python and the Holy Grail [Core Expansion 3, Party Box Expansion 1]
Camels	One hump or two? [Junior Set (2nd)]
Cameras	"And this is a picture from our summer vacation..." [Junior Set (2nd)]
Campfire	S'mores and songs. Gather 'round! [Junior Set (2nd)]
Camping	Shhh! Did you hear that noise? [Junior Set (1st) & (2nd)]
Camping Trip	When you just have to get s'more nature. [Core Expansion 2, Party Box]
Canada	Federated country of North America. The Great White North - eh? [Core Set, Party Box]
Canada	Largest country in North America. Canada is located north of the U.S. [Junior Set (1st) & (2nd)]
Canadians	How many Canadians does it take to screw in a lightbulb? Fifteen. Fourteen to chip it out of the ice, and one to screw it in. [Core Set, Party Box]
Candles	How many candles are on your birthday cake? [Kids Set]
Candy	Lollipops, jelly beans, chocolates, and lots more. All the good stuff! [Kids Set]
Candy Corn	It may be corn but it's not a vegetable. [Junior Set (1st) & (2nd)]
Canoes	Light, narrow boats. Don't stand up! [Junior Set (1st) & (2nd)]
Captain Kirk	Fictional starship captain. "Beam me up Scotty, there is no intelligent life on this planet!" - bumper sticker, 1980s [Core Set, Party Box]
Car Bombs	Not including the Ford Pinto, of course. [Core Expansion 1, Party Box]
Car Crash	Always wear your seatbelt. [Junior Set (1st) & (2nd)]
Car Horns	Blow it, buddy! [Core Set, Party Box]
Card Games	"Apples to Apples" might be fun! [Junior Set (1st) & (2nd)]
Carl Sagan	1934-96, American astronomer and pioneer exobiologist. Touched many lives. Billions and billions of them. [Core Set, Party Box]
Carlos Santana	1947-, guitar legend and member of the Rock and Roll Hall of Fame. Truly Supernatural. [Core Expansion 3, Party Box Expansion 1]
Carnival Workers	Step right up ... [Core Expansion 1, Party Box]
Carpenters	Hammering and sawing- it's just wood work. [Junior Set (2nd)]
Carrot & A Stick	The ultimate motivator... for a donkey. [Core Expansion 4, Party Box Expansion 1]
Carrots	Bugs Bunny's favorite food. [Junior Set (1st) & (2nd)]
Cary Grant	1904-86, British-born American actor known for his debonair manner. He can be found North by Northwest. [Core Expansion 2, Party Box]
Casablanca	The largest city in Morocco, and one heck of a good movie. "Of all the gin joints in all the towns in all the world..." [Core Expansion 2, Party Box]
Casinos	Slots and slots of fun. [Core Expansion 1, Party Box]
Castles	Kings, queens, knights in shining armor, and little square hamburgers. [Core Expansion 2, Party Box]
Castles	Some have towers, dungeons and moats. [Junior Set (1st) & (2nd)]
Cat & Mouse	It's just a game. [Core Expansion 4, Party Box Expansion 1]
Catfish	Fish with feelers that look like whiskers. [Kids Set]
Catherine Zeta-Jones	1969-, Welsh born actor, famous for her stunning good looks, as seen in The Mask Of Zorro, Entrapment and Traffic. [Core Expansion 3, Party Box Expansion 1]
Cats & Dogs	Is it raining? [Core Expansion 4, Party Box Expansion 1]
Catsup	Catsup is made from tomatoes, onions, sugar, and spices. [Junior Set (2nd)]
Catsup & Mustard	The salsa revolution brought down their condiment empire. [Core Expansion 4, Party Box Expansion 1]
Cattle Ranch	Home on the range. [Junior Set (2nd)]
Cavities	But I did brush my teeth! [Junior Set (2nd)]
Cauliflower	Goes down easy when it's cheesy. [Core Expansion 3, Party Box Expansion 1]
Caves	Stalactites, stalagmites. Which go up and which go down? [Core Expansion 1, Party Box]
Caves	Dark and cool, and sometimes home to bats. [Junior Set (1st) & (2nd)]
Caviar	It's not JUST fish eggs. It's . . . fish eggs . . . that cost a fortune . . . [Core Expansion 3, Party Box Expansion 1]
CD Players	Your portable, personal stereo system. [Junior Set (2nd)]
Celine Dion	1968-, Canadian singer whose heart will go on, and on ... [Core Set, Party Box]
Cell Phones	Get off the phone or get off the road! [Core Expansion 1, Party Box]
Cell Phones	Call home if you're going to be late. [Junior Set (2nd)]
Cesar Chavez	1927-93, American labor leader who led the 1965 nationwide boycott of California grapes ... a bunch of sour grapes! [Core Expansion 1, Party Box]
Chain Letters	Send this game to ten of your friends and good luck will follow. Honest! [Core Expansion 1, Party Box]
Chain Link Fences	Good fences make good neighbors. [Core Expansion 3, Party Box Expansion 1]
Chains	Gold or iron: name your shackles. [Core Set, Party Box]
Challenger Explosion	"Without a wish, without a will/ I stood upon that silent hill/ and stared into the sky ..." - Ralph Hodgeson [Core Set, Party Box]
Chameleons	The chameleon is a lizard that changes color when frightened -or is that a politician? [Core Expansion 1, Party Box]
Charging Rhinos	How do you stop a rhino from charging? Take away its credit cards. [Core Set, Party Box]
Charles & Diana	A right royal marriage. [Core Expansion 4, Party Box Expansion 1]
Charlie Brown	"Peanuts" cartoon character, friend of Linus and Lucy. [Kids Set]
Charlotte's Web	Award-winning book by E.B. White featuring Charlotte the spider, and a pig named Wilbur. [Junior Set (2nd)]
Chat Rooms	Electronic speakeasies for the information age. [Core Expansion 3, Party Box Expansion 1]
Cheerleaders	"Go, Team, Go!" [Junior Set (1st) & (2nd)]
Cheese	Swiss cheese, American cheese, cottage cheese. Say cheese! [Kids Set]
Cheese Sandwich	Two pieces of bread and a slice of cheese. Grill it, if you want. [Junior Set (1st) & (2nd)]
Cheesecake	A really tasty dish. [Core Expansion 1, Party Box]
Cher	1946- , American singer and actor, she makes aging look good. [Core Set, Party Box]
Cherries	And a cherry on top! [Junior Set (2nd)]
Cherry Pie	A flaky pastry filled with cherries. [Kids Set]
Chewing Your Fingernails	Hungry? [Junior Set (2nd)]
Chicken Nuggets	Bite-sized pieces of fried chicken. Finger food! [Junior Set (2nd)]
Chicago	Third largest city in the United States. Our kind of town. [Core Set, Party Box]
Chicken Pox	Infectious disease usually contracted in childhood. Just don't scratch 'em! [Core Expansion 1, Party Box]
Chicken Pox	An illness that comes with a fever and itchy red bumps. Don't scratch! [Junior Set (1st) & (2nd)]
Chickens	From incubator to rotisserie in 56 days! Run, chicken, run! [Core Expansion 2, Party Box]
Chickens	Hens and roosters. Cluck-cluck, cock-a-doodle-do! [Kids Set]
Chimpanzees	Sure, they're related to us; but they don't write, and they NEVER call! [Core Set, Party Box]
China	The most populous country in the world. More than one-fifth of the world's total population lives within its borders. [Core Set, Party Box]
China	There are over one billion people living in the People's Republic of China. [Junior Set (2nd)]
Chinatown	International travel, just around the corner. [Core Expansion 2, Party Box]
Chips & Dip	No double dipping! [Core Expansion 4, Party Box Expansion 1]
Chips & Salsa	Nacho average snack! [Core Expansion 4, Party Box Expansion 1]
Chocolate Milk	Good for you and tastes good too! [Junior Set (1st) & (2nd)]
Choir Boys	They sound angelic, but ... [Core Expansion 2, Party Box]
Chopsticks	A pair of small, slender sticks used for eating. Just try eating peas. [Junior Set (2nd)]
Chorus Girls	Long legs and high kicks! [Core Expansion 2, Party Box]
Christmas	December 25th, a Christian holiday that is celebrated around the world. [Kids Set]
Churches	"Here is the church, and here is the steeple..." [Junior Set (2nd)]
Chutes & Ladders	A game of ups and downs. [Core Expansion 4, Party Box Expansion 1]
Cigarette Burns	Another reason to give up smoking. [Core Expansion 2, Party Box]
Cigarettes	Mind if I smoke? [Core Set, Party Box]
Cinco de Mayo	Marks the victory of the Mexican Army over the French at the Battle of Puebla, in 1862. [Core Set, Party Box]
Cinderella	A storybook character who is helped by her fairy godmother. Bibbidi-bobbidi-boo! [Kids Set]
Cindy Crawford	1966- , American Supermodel. What dreams are made of. [Core Set, Party Box]
Circus Peanuts	Chewy, orange marshmallow things shaped like peanuts. Seldom found at the circus. [Core Expansion 3, Party Box Expansion 1]
Clark Gable	1901-60, American film actor, noted as a romantic lead. Frankly, my dear, he didn't give a damn. [Core Set, Party Box]
Claude Monet	1840-1926, French painter, regarded as one of the leaders on the impressionist movement. [Core Set, Party Box]
Clay	The oven where pottery is hardened is called a kiln. [Junior Set (1st) & (2nd)]
Cleaning The Bathroom	It's YOUR turn! [Core Expansion 2, Party Box]
Cleaning Your Room	It's no fun, but you have to do it. [Kids Set]
Cleopatra	c. 69-30 BC, Queen of Egypt, noted for love affairs with Julius Caesar and Mark Antony, which came back to bite her in the asp. [Core Set, Party Box]
Cleveland	"Cleveland rocks! Cleveland rocks!" - The Drew Carey Show [Core Expansion 3, Party Box Expansion 1]
Climbing A Ladder	Don't look down! [Junior Set (1st) & (2nd)]
Climbing A Tree	Don't go out on a limb! [Junior Set (2nd)]
Clint Eastwood	1930-, American film actor and director, past mayor of Carmel, California. Has earned fistfuls of dollars. [Core Set, Party Box]
Cloned Sheep	Dolly good show! [Core Expansion 3, Party Box Expansion 1]
Clouds	I see an elephant! And that one looks like a rabbit. [Junior Set (1st) & (2nd)]
Clowns	They would be really funny if they weren't so darn scary. [Core Expansion 1, Party Box]
Clowns	They often dress in silly outfits and paint their faces! [Kids Set]
Cocaine	Alkaloid obtained from leaves of the coca plant and used as a local anesthetic and abused as a drug. [Core Set, Party Box]
Cockles & Mussels	"Alive--alive-o!" I think I just lost my appetite. [Core Expansion 4, Party Box Expansion 1]
Cockroaches	Annoying insects that can survive a nuclear war. Fortunately, they can't survive the heel of your shoe. [Core Set, Party Box]
Coconuts	"Put the lime in the coconut, and drank them both up." -Harry Nillson [Core Expansion 2, Party Box]
Coffee	Two-thirds of the world's coffee beans are grown in Central and Southern America. [Junior Set (1st) & (2nd)]
Cold Pizza	The breakfast of champions. [Core Expansion 1, Party Box]
Colin Powell	1937-, U.S. Secretary of State and Chairman of the Join Chiefs of Staff during the Gulf War. We'd give him four stars. [Core Expansion 3, Party Box Expansion 1]
Collection Shells	She sells seashells by the seashore. [Junior Set (1st) & (2nd)]
Comic Books	THIS looks like a job for . . . somebody who draws Superman! [Core Expansion 3, Party Box Expansion 1]
Communists	"From each, according to their ability, to each according to their need." I need a new Ferrari. [Core Set, Party Box]
Commuting	The daily grind. And we're not talking coffee. [Core Set, Party Box]
Computer Hackers	We didn't mean to shut down the entire government ... [Core Expansion 2, Party Box]
Computers	British mathematician Charles Babbage worked out the principles of the modern digital computer in the late 1800s. [Core Set, Party Box]
Computers	Great for games, homework, and e-mail. [Junior Set (1st) & (2nd)]
Confucius	c. 551-479 BC, K'ung Fu-Tzu, Chinese philosopher and one of the most influential figures in Chinese history. [Core Set, Party Box]
Conspiracy Theories	Oh, that was just a coincidence! [Core Expansion 1, Party Box]
Construction Workers	Hard hats -hard bodies. [Core Expansion 1, Party Box]
Convenience Stores	"Thank you come again." [Core Expansion 3, Party Box Expansion 1]
Cookies	Chocolate chip, oatmeal, sugar or peanut butter. [Junior Set (1st) & (2nd)]
Cooking Dinner	What's for dinner? [Junior Set (1st) & (2nd)]
Cops & Robbers	When fighting crime was just child's play. [Core Expansion 4, Party Box Expansion 1]
Coral Reef	Composed of the skeletons of marine organisms. Home to lots of tropical fish. [Junior Set (2nd)]
Corn Fields	Knee high by the Fourth of July. [Core Expansion 3, Party Box Expansion 1]
Corn Flakes	Eat them fast or they'll get soggy. [Junior Set (1st) & (2nd)]
Corn On The Cob	A grain native to the Americas, corn was a staple food for many centuries before corn holders were invented. [Core Set, Party Box]
Corn On The Cob	It's a summertime treat that gets stuck in your teeth. [Kids Set]
Corned Beef & Cabbage	It's not chopped liver. [Core Expansion 4, Party Box Expansion 1]
Corrugated Cardboard	When you want to think out of the box . . . [Core Expansion 3, Party Box Expansion 1]
Corvettes	In 1953, Chevrolet introduced the Corverre, the first mass-produced sports car with a fiberglass body. The perfect cure for a midlife crisis. [Core Expansion 1, Party Box]
Cottage Cheese	If it's so popular, where are all the Cottage Cheeseheads? [Core Expansion 3, Party Box Expansion 1]
Cotton Candy	Looks like cotton; tastes like candy. [Kids Set]
Coughing & Sneezing	And no cure in sight. [Core Expansion 4, Party Box Expansion 1]
Count Dracula	"I vant to suck your blood!" [Core Expansion 1, Party Box]
Country Music	Encompassing styles such as western swing, honky-tonk, bluegrass and rockabilly. Should mention a pickup truck and a dog named "Bo." [Core Expansion 2, Party Box]
Cow-Pies	When dried, these "cow chips" are hurled discus-like over great distances. It's true. [Core Set, Party Box]
Cowboys	Head 'em up and move 'em out! [Core Expansion 3, Party Box Expansion 1]
Cowboys	Men who take care of cattle on a ranch. [Kids Set]
Cowboys & Indians	How the west was won... and lost. [Core Expansion 4, Party Box Expansion 1]
Cows	Large farm animals raised for milk. Moo. [Kids Set]
Crabs	As crustaceans, crabs are related to lobster and shrimp. What do they all have in common? They all go well with butter. [Core Expansion 3, Party Box Expansion 1]
Crash & Burn	Try, try again. [Core Expansion 4, Party Box Expansion 1]
Crazy Horse	1849?-77, chief of the Oglala Sioux. A leader in the Native American resistance to the westward expansion on the United States. [Core Expansion 1, Party Box]
Cream & Sugar	Do you want some coffee with that? [Core Expansion 4, Party Box Expansion 1]
Creamed Corn	Eat it, it's good for you. [Core Expansion 1, Party Box]
Crime & Punishment	Fyodor Dostoevsky's 1917 classic novel following the tormented life of the murderer Rodion Romanovich Roskolnikov. [Core Expansion 4, Party Box Expansion 1]
Crying	"Don't cry over spilled milk." [Junior Set (1st) & (2nd)]
Crystal Balls	I see a Green Apple card in your future. [Core Expansion 2, Party Box]
Cuba	Island republic in the Caribbean, just south of Florida. Beans and rice never tasted so good. [Core Expansion 2, Party Box]
Cults	They seemed nice ... [Core Expansion 1, Party Box]
Cup & Saucer	Tea Time! [Core Expansion 4, Party Box Expansion 1]
Cupcakes	Small cakes, the size of a cup. [Junior Set (1st) & (2nd)]
Curds & Whey	What? It's just cottage cheese? [Core Expansion 4, Party Box Expansion 1]
Currier & Ives	The lithography shop operated from 1834 to 1907 and produced over 7500 titles, all of which could have been called "Life In America." [Core Expansion 4, Party Box Expansion 1]
Custer's Last Stand	1866, Little Big Horn. Very big mistake. [Core Set, Party Box]
Cut & Curl	You'll look mah-velous! [Core Expansion 4, Party Box Expansion 1]
Cutting The Grass	Why cut it? It just grows back. [Junior Set (2nd)]
D-Day, 1944	On June 6, 1944 the Allied forces invaded France, employing over 10,000 airplanes, 5,000 ships, and 250,000 servicemen. [Core Expansion 3, Party Box Expansion 1]
Dallas & Fort Worth	The heart & soul of Texas. [Core Expansion 4, Party Box Expansion 1]
Dance Class	Step, turn, hop, hop, kick... [Junior Set (2nd)]
Dancing	Moving your feet and body in time with music. Cha-cha-cha. [Kids Set]
Dandruff	Dry skin on your scalp? Sounds a bit flaky. [Core Set, Party Box]
Danielle Steel	1947- , Prolific romance novelist. "Suddenly, Stephanie spotted Lance on the beach ..." [Core Expansion 1, Party Box]
Danny DeVito	1944- , American television, motion-picture actor, and director. Star of Taxi, Romancing The Stone, Twins, and Get Shorty. [Core Expansion 2, Party Box]
Dark Alleys	Don't go there! [Core Expansion 1, Party Box]
Dark Alleys	I thought you brought the good flashlight! [Junior Set (2nd)]
Darth Vader	"Luke ... (wheeze) .. I am ... (wheeze) ... your father ... and you don't write, you don't call ... NOTHING." [Core Expansion 1, Party Box]
Dating	First stage of the human mating ritual. [Core Expansion 2, Party Box]
David & Goliath	Bible story featuring the future king David and the Philistine giant Goliath. The bigger they come, the harder they fall. [Core Expansion 4, Party Box Expansion 1]
David Letterman	1947- , American television entertainer and talk-show host. And ... the Number One reason to watch him (drum roll, please): TOP TEN LISTS! [Core Expansion 1, Party Box]
Day Care Centers	Preschool for preschool. [Core Expansion 3, Party Box Expansion 1]
Daytime TV	Soap operas, game shows, talk shows and reruns ... is this a great country or what? [Core Expansion 2, Party Box]
Dead Fish	Floating in the water, washed up on shore, or at a fish market. [Junior Set (1st) & (2nd)]
Death & Dying	The only way out. [Core Expansion 4, Party Box Expansion 1]
Death & Taxes	The two certainties in life. [Core Expansion 4, Party Box Expansion 1]
Death Valley	Arid, desolate and hellish region of California. Named by a survivor of an atJunior Setted 1849 crossing. [Core Expansion 1, Party Box]
Deer Hunting	Nooo! Nooooo! Not BAMBI'S MOTHER! [Core Expansion 1, Party Box]
Demi Moore	1962-, American actor in St. Elmo's Fire, Ghost and GI Jane. [Core Expansion 1, Party Box]
Democrats	Their symbol is the donkey, or ass. Insert your own joke here. [Core Set, Party Box]
Dennis Rodman	1961- , American professional basketball player and full-time human oddity. [Core Set (1999 Printing Only)]
Denzel Washington	1954- , American actor known for his powerful roles in such movies as Cry Freedom, Malcolm X, and Mississippi Masala. [Core Expansion 2, Party Box]
Detroit	The Motor City is the world's foremost automobile manufacturing center, and the tenth largest city in the U.S. [Core Set, Party Box]
Diamonds	The hard fact: they are just highly refractive crystalline allotropes. [Core Set, Party Box]
Dictionaries	Let me look that up! [Junior Set (2nd)]
Dinner & A Movie	And a mortgage to pay for it. [Core Expansion 4, Party Box Expansion 1]
Dinosaurs	Reptiles that lived millions of years ago. Some, like the T. rex, were huge! [Kids Set]
Dirt	Good in the garden. [Junior Set (1st) & (2nd)]
Dirty Diapers	It must be time to change the baby! [Kids Set]
Dirty Dishes	That's why they make paper plates! [Junior Set (2nd)]
Dirty Socks	Put them in the wash! [Kids Set]
Discos	Where you go to catch "Saturday Night Fever." [Core Expansion 1, Party Box]
Discovering America	1492, Christopher Columbus discovered that America was discovered centuries before he arrived. [Core Set, Party Box]
Disneyland	You've just won the "Apples to Apples(R) Grand Masters Tournament." Where're you gonna go? [Core Set, Party Box]
Disneyland	A theme park featuring cartoon characters like Mickey Mouse and Donald Duck.. [Kids Set]
Divorce	It's a trial separation that goes to trial. [Core Expansion 2, Party Box]
Doctors	Over twenty years of education and they're still "practicing" medicine? [Core Expansion 2, Party Box]
Doctors	Stick out your tongue and say aaaaah! [Junior Set (1st) & (2nd)]
Doctors & Dentists	For a long life and healthy teeth. [Core Expansion 4, Party Box Expansion 1]
Dollars & Cents	"If it don't make dollars, it don't make sense." - DJ Quik [Core Expansion 4, Party Box Expansion 1]
Dodo Birds	A large, flightless bird of the island of Mauritius. Discovered by Europeans in 1598, extinct by 1681. [Core Expansion 3, Party Box Expansion 1]
Dog Days	101 degrees in the shade. [Core Expansion 3, Party Box Expansion 1]
Dog Food	I like the chewy kind. [Junior Set (2nd)]
Doing The Dishes	You wash, I'll watch. [Core Set, Party Box]
Doing The Dishes	I'll wash the dishes and you can dry. [Kids Set]
Doing The Hokey-Pokey	That's what it's all about. [Core Expansion 3, Party Box Expansion 1]
Dolly Parton	1967- , American singer, songwriter, and actor. Known as much for her personal style as for her successful career. [Core Expansion 1, Party Box]
Dolphins	Dolphins are mammals that live in the sea, and Sea World. [Junior Set (2nd)]
Donuts	In 1993, a doughnut weighing over 3,700 pounds was made in Utica, N.Y. [Junior Set (2nd)]
Doorbells	Would someone please answer the door? [Junior Set (1st) & (2nd)]
Double Thick Malts	For a double thick ice cream headache. [Core Expansion 3, Party Box Expansion 1]
Dr. Evil	Arch-nemesis of Austin Powers. Riiiiiiight. [Core Expansion 3, Party Box Expansion 1]
Dr. Jekyll & Mr. Hyde	Robert Louis Stevenson's 1887 novel revealing the hypocrisy and innate evilness in society. The idea came to him in a dream - a bad dream. [Core Expansion 4, Party Box Expansion 1]
Dr. Kevorkin	1928- , Controversial advocate of doctor-assisted suicide. [Core Set, Party Box]
Dr. Laura	1947-, American conservative talk show host and promoter of family values. HER family values, that is . . . [Core Expansion 3, Party Box Expansion 1]
Dr. Seuss	1904-1991, Theodor Suess Geisel , the cat who came up with "The Cat in the Hat." [Core Set, Party Box]
Dragons	Pretend animals that look like giant lizards with wings. Sometimes they breath fire! [Kids Set]
Drew Barrymore	1975-, heir to the Barrymore acting dynasty. Drew starred in ET, The Wedding Singer, Charlie's Angels, and countless tabloid stories. [Core Expansion 3, Party Box Expansion 1]
Drew Carey	1958-, American comedian and television star. Whose line is it anyway? His. [Core Expansion 3, Party Box Expansion 1]
Drinking & Driving	Friends don't let friends drive drunk. [Core Expansion 4, Party Box Expansion 1]
Driving A Car	In most states, you have to be 16 years old to drive a car. [Junior Set (1st) & (2nd)]
Driving Off A Cliff	It was either that or hire someone to do my takes. [Core Expansion 2, Party Box]
Drums	Beat it! [Kids Set]
Drunk Drivers	Number one highway safety problem. [Core Expansion 3, Party Box Expansion 1]
Ducks	Large birds with webbed feet and a flat bill. Quack-quack-quack! [Kids Set]
Duct Tape	All-purpose, ... all the time ... [Core Set, Party Box]
Dumb Blonde Jokes	Are they just naturally funny? [Core Expansion 3, Party Box Expansion 1]
Dumbo	A little elephant cartoon character. When he flaps his ears, he can fly! [Kids Set]
Dump Trucks	Large trucks that carry dirt, sand, and rocks. [Junior Set (1st) & (2nd)]
Dungeons & Dragons	Popular role-playing game featuring swords, sorcery and wizards. Repeat after me: it's a game... it's only a game... [Core Expansion 4, Party Box Expansion 1]
Dustin Hoffman	1937-, highly regarded actor of The Graduate, Midnight Cowboy, and Rainman. He's an excellent driver! [Core Expansion 3, Party Box Expansion 1]
E-Mail	You've got JUNK mail! [Core Expansion 1, Party Box]
Ear Wax	A waxy, yellowish substance that protects the ear from dust, bacteria, and from hearing things you don't want to hear. [Core Expansion 1, Party Box]
Early Morning	"The early bird gets the worm!" [Junior Set (2nd)]
Ears	What? [Junior Set (2nd)]
Earthquakes	The Richter scale is named after the American seismologist Charles Richter. Did the earth move for you? [Core Set, Party Box]
Earwigs	Nocturnal insects with abdominal pincers. Nothing to do with ears or wigs. [Core Expansion 2, Party Box]
East Coast	From New England to Florida. They're not like folks 'round here ... [Core Set, Party Box]
Eating Breakfast	It's always breakfast time at a truck stop. [Junior Set (1st) & (2nd)]
Ebony & Ivory	"Ebony and Ivory live together in perfect harmony." - Paul McCartney [Core Expansion 4, Party Box Expansion 1]
Eddie Murphy	1961-, American comedian, actor, and producer. Best known for his work in 48 Hours, Beverly Hills Cop and on Saturday Night Live. [Core Expansion 1, Party Box]
Egg Rolls	Crunchy rolls filled with vegetables and meat. Available at Chinese restaurants. [Junior Set (1st) & (2nd)]
Eggplant	Without it there would be no Eggplant Parmesan. [Core Expansion 3, Party Box Expansion 1]
Eggs	Birds, fish, snakes and insects all lay eggs. [Junior Set (1st) & (2nd)]
Eleanor Roosevelt	1884-1962, first lady, social activist, author, lecturer, and U.S. representative to the United Nations. [Core Set, Party Box]
Electric Eels	Slippery and slimy snakelike fishes that emit electrical charges. The shocking truth! [Core Expansion 1, Party Box]
Electricity	The repulsive or attractive force between two stationary bodies. No problem unless one of those bodies is yours. [Core Set, Party Box]
Elephants	The largest living land mammal, with two species: Indian and African. Not counting Dumbo, there are no American elephants. [Core Set, Party Box]
Elephants	Huge gray animals with large ears and trunks. Some elephants have tusks. [Kids Set]
Elevators	The 110-story Sears Tower in Chicago has 104 elevators. [Junior Set (2nd)]
Elizabeth Taylor	1932- , American actor, noted for her lush beauty, emotional performances and multiple husbands. [Core Set, Party Box]
Elmo	A little, red, fuzzy guy from Sesame Street. Tickle me! [Junior Set (1st) & (2nd)]
Elvis Presley	1935-77, American singer and actor and the king of rock-and-roll. His death left the music world all shook up. [Core Set, Party Box]
Emergency Rooms	Brings new meaning to he word "heartthrob." [Core Expansion 3, Party Box Expansion 1]
Emily Dickinson	1830-86, American poet, whose lyrics are psychologically astute treatments of love, death, and immortality. So there. [Core Set, Party Box]
Erasers	Because everybody makes mistakes. [Junior Set (2nd)]
Ernest Hemingway	1899-1961, American novelist and short-story writer, whose macho style is crisp, laconic and understated. [Core Set, Party Box]
Europe	The Old Country ... except to people who live there. [Core Set, Party Box]
Exorcism	To ceremoniously expel an evil spirit. [Core Expansion 1, Party Box]
Exterminators	Bugs, rats and vermin. It's time for chemical warfare. [Core Expansion 3, Party Box Expansion 1]
Eyes	Light-sensitive organ of vision in animals. See? [Core Set, Party Box]
Eyes	Flies have five eyes. [Junior Set (1st) & (2nd)]
Face Paint	You can be a clown, a pirate, a cat, or whatever you want. [Kids Set]
Factories	Oompa-Loompa! Willy Wonka and the Chocolate Factory! [Junior Set (2nd)]
Fairies	Tiny, mischievous, mythical beings with magic powers. They live in Fairyland. Really. [Core Expansion 3, Party Box Expansion 1]
Fairies	Tiny storybook characters with wings and magic powers. [Junior Set (1st) & (2nd)]
Faith Hill	1967-, American crossover country music artist. You just gotta have Faith. [Core Expansion 3, Party Box Expansion 1]
Falling Down	"What we call failure is not the falling down, but the staying down." -Mary Pickford [Core Expansion 1, Party Box]
Fame & Fortune	Everybody may have 15 minutes of fame, but fortune is another thing altogether. [Core Expansion 4, Party Box Expansion 1]
Family Reunions	Just to remind you why you moved away in the first place ... [Core Expansion 1, Party Box]
Family Vacations	Dad? Dad? Are we there yet? Are we there yet? Are we? Huh? Dad? [Core Expansion 1, Party Box]
Family Values	Often said but seldom understood. [Core Expansion 2, Party Box]
Farmers	There's a farmer in the dell. [Junior Set (1st) & (2nd)]
Farms	A place where animals and crops are raised for food. "Old McDonald had a farm." [Kids Set]
Fast Food	You want fries with that? [Core Expansion 1, Party Box]
Fat	I can't believe I ate the whooooooole thing. [Core Expansion 3, Party Box Expansion 1]
Fear & Loathing	In Las Vegas, or anywhere else. [Core Expansion 4, Party Box Expansion 1]
Feathers	Which weighs more, a pound of feathers or a pound of rocks? [Core Expansion 2, Party Box]
Feathers	Feathers protect a bird's skin, keep them warm, and help them fly. [Junior Set (1st) & (2nd)]
Feminists	Political and social activists who support selected women's causes. [Core Expansion 2, Party Box]
Ferdinand & Isabella	Late 15th century king and queen of Spain. They backed Christopher Columbus and benefitted royally. [Core Expansion 4, Party Box Expansion 1]
Fertilizer	Viagra for the garden. [Core Expansion 3, Party Box Expansion 1]
Festering Wounds	Quit picking at that! [Core Expansion 1, Party Box]
Fidel Castro	1927-, Cuban revolutionary and Communist dictator since 1976. He earned a PhD in law in 1950. [Core Set, Party Box]
Field & Stream	The hunter's best friend. [Core Expansion 4, Party Box Expansion 1]
Finger Painting	Just paint with your fingers. No brush needed! [Kids Set]
Fire	Don't get burned! [Kids Set]
Firefighters	Emperor Augustus instituted a corps of fire-fighting "watchmen" in 24 B.C. Nero, on the other hand, fiddled while Rome burned. [Core Set, Party Box]
Firefighters	Their job is to put out fires. They also get to drive fire engines. [Kids Set]
Firestorms	Some severe wildfires require more than 10,000 firefighters. And, wouldn't ya know it, some idiot parked in front of the hydrant! [Core Set, Party Box]
Fireworks	Includes firecrackers, Roman candles, and bottle rockets. It's all fun until someone loses an eye ... and a nose ... and an arm ... [Core Expansion 1, Party Box]
Fireworks	Bright, explosive displays often used for the 4th of July. Bang-Boom-Pop-Pop! Ohhh-Ahhh! [Kids Set]
First Man On The Moon	July 20, 1969. "That's one small step for a man, one giant leap for mankind." -Neil A. Armstrong [Core Set, Party Box]
Fish & Chips	Just wrap it in any old newspaper. [Core Expansion 4, Party Box Expansion 1]
Fishing	The perfect way to spend a summer day. Maybe you'll catch a big one! [Kids Set]
Flags	There are fifty stars and thirteen stripes on the flag of the United States of America. [Junior Set (1st) & (2nd)]
Flannel Shirts	Pick your plaid. [Core Expansion 3, Party Box Expansion 1]
Flash Floods	Too late for sandbags! [Core Expansion 3, Party Box Expansion 1]
Flashlights	Good for camping and reading under the covers. [Junior Set (1st) & (2nd)]
Flies	A group of insects with wings. They enjoy picnics. [Junior Set (1st) & (2nd)]
Flip-Flops	It's the sound they make when you walk. [Junior Set (2nd)]
Flipper	American television dolphin of the 1960's ... like Lassie, only wetter. [Core Expansion 2, Party Box]
Floods	Heavy rains and melting snow can cause floods. [Junior Set (1st) & (2nd)]
Florence Nightengale	1820-1910, English nurse and health-care reformer. We've been singing her praises for years. [Core Expansion 3, Party Box Expansion 1]
Flour	Flour is made by grinding wheat and other grains. [Junior Set (2nd)]
Flower Gardens	No weeds allowed. [Junior Set (2nd)]
Flowers & Candy	When "I'm sorry" is not enough. [Core Expansion 4, Party Box Expansion 1]
Fly Fishing	... if you can"t catch flies any OTHER way ... [Core Expansion 1, Party Box]
Flying A Kite	Don't let go of the string! [Kids Set]
Flying Monkeys	The reason why "The Wizard Of Oz" still gives us nightmares. [Core Expansion 1, Party Box]
Folk Music	When you're just fiddling around . . . [Core Expansion 3, Party Box Expansion 1]
Food & Shelter	Gotta have it. [Core Expansion 4, Party Box Expansion 1]
Food Poisoning	This chicken tastes kinda funny . . . [Core Expansion 3, Party Box Expansion 1]
Foot & Mouth	An infectious disease of animals with hooves. Not the same as foot-IN-mouth disease which affects everybody at one time or another. [Core Expansion 4, Party Box Expansion 1]
Football	It's a ball AND a game. [Junior Set (1st) & (2nd)]
Football Players	Punt, pass, and kick! [Kids Set]
Forest Fires	"Only YOU can prevent forest fires." The heat is on! [Core Expansion 2, Party Box]
Forest Fires	Lightning can start forest fires. [Junior Set (1st) & (2nd)]
Forever & Ever	"Oh baby, I'm gonna love you forever / Forever and ever amen." - Randy Travis [Core Expansion 4, Party Box Expansion 1]
Fort Knox	American military post in Kentucky, containing the greater part of the gold reserve of the U.S. government. [Core Expansion 1, Party Box]
Fortune Cookies	"You will soon eat a flat, dry, tasteless cookie . . ." [Core Expansion 3, Party Box Expansion 1]
Fortune Teller	"My crystal ball says ..." [Junior Set (2nd)]
Fourth Of July	"Independence Day" in the United States. "Thank Goodness We Got Rid of Them Day" in Britain. [Core Set, Party Box]
Fourth Of July	The United States Independence Day. Lots of picnics and fireworks! [Kids Set]
Frank Lloyd Wright	1867-1959, pioneering American architect. Considered one of the greatest designers of the 20th century. [Core Expansion 1, Party Box]
Frank Sinatra	1915-98, the greatest American pop singer of his generation, award winning film and television actor. Do-be do-be do, baby. [Core Set, Party Box]
Freaks & Geeks	The 1999 television show, or those outside the social norm. [Core Expansion 4, Party Box Expansion 1]
Freckles	No matter what they tell you, freckles won't grow together to form a great-looking tan. [Core Expansion 1, Party Box]
Freckles	The more the merrier! [Junior Set (2nd)]
Fred & Ginger	Fred Astair & Ginger Rogers - tap dancing their way into the hearts of millions. [Core Expansion 4, Party Box Expansion 1]
Fred & Wilma	Meet the Flintstones. "Yabba-dabba-doooo!" [Core Expansion 4, Party Box Expansion 1]
Fred Flintstone	Yaba-daba-dooooo! [Core Expansion 3, Party Box Expansion 1]
Freedom	Express yourself! [Core Expansion 1, Party Box]
French Fries	In Europe, French fries are usually eaten with a fork. [Junior Set (1st) & (2nd)]
French Wines	The perfect complement to an overpriced meal. [Core Expansion 2, Party Box]
Fresh Water Pearls	String them along ... [Core Expansion 2, Party Box]
Friction	Resistance to the motion of a body in contact with another body ... any body will do. [Core Set, Party Box]
Friends & Family	There when you need them. [Core Expansion 4, Party Box Expansion 1]
Frisbees	The frisbee was introduced to the market in 1948. Take one for a spin. [Core Expansion 3, Party Box Expansion 1]
Frog & Toad	Characters in a series of children's books by Arnold Lobel, or any of the millions of frogs and toads who choose not to wear clothes. [Core Expansion 4, Party Box Expansion 1]
Frogs	Some frogs can jump 20 feet. [Junior Set (1st) & (2nd)]
Frosty The Snowman	This snowman has a corncob pipe and a button nose. [Kids Set]
Frozen Peas	Right under the frozen pizza. [Junior Set (2nd)]
Fund Raising	Hello ... my name is Jonathan, would you like to buy some fruit, magazines, candy bars, wreaths, pizzas ... ? [Core Expansion 2, Party Box]
Funerals	"He who dies with the most toys is, nonetheless, still dead." - Anonymous [Core Set, Party Box]
Fur	The characteristic covering of mammals and people with money. [Core Set, Party Box]
Fur	The soft, hairy covering on the skin of some animals. [Kids Set]
Fuzz	Lint ... Policemen ... Whatever ... [Core Set, Party Box]
Gall Bladder	Where excess bile is stored. Stored for what, we don't know. [Core Expansion 2, Party Box]
Gang Members	"When you're a Jet, you're a Jet all the way..." -West Side Story [Core Set, Party Box]
Garages	Little houses for cars. [Junior Set (2nd)]
Garbage Cans	A restaurant for raccoons. [Junior Set (1st) & (2nd)]
Gardening	Get in touch with your roots. [Core Expansion 3, Party Box Expansion 1]
Garrison Keillor	1942- , American author and radio star. He shares the Midwest perspective with 2.6 million listeners each week on A Prairie Home Companion. [Core Expansion 2, Party Box]
Garth Brooks	1962- , American country music singer and songwriter. He's got friends in low places. [Core Set, Party Box]
Gas Stations	How far to the next gas station? [Junior Set (1st) & (2nd)]
Geishas	Japanese women training in traditional singing, dancing, and entertaining. Of course, you would never recognize them without all that make-up. [Core Expansion 2, Party Box]
Gen. George S. Patton	1885-1945, the commander of the American Third Army during World War II. -a.k.a. Olf Blood and Guts [Core Expansion 1, Party Box]
Genetic Engineering	What DO you get when you cross a monkey with a potato? [Core Expansion 2, Party Box]
George & Jane, His Wife	The Jetsons television show first aired in 1962. In spite of our best efforts, cars still can't fly. [Core Expansion 4, Party Box Expansion 1]
Ghosts & Goblins	"I see dead people." - Cole Sear, The Sixth Sense [Core Expansion 4, Party Box Expansion 1]
George W. Bush	1946- , 43rd president of the United States. The second time ever that the son of a former president was elected to the office. (Core Set (2001 Printing Forward), Party Box]
George Washington	1732-99, First President of the United States. He chopped down a cherry tree to make false teeth, or something like that ... [Core Expansion 2, Party Box]
George Washington	First president of the United States. [Kids Set]
Georgia O'Keeffe	1887-1986, American abstract painter known for her still life compositions. Her skull paintings prove that beauty is more than skin deep. [Core Expansion 1, Party Box]
Getting A Haircut	It will always grow back. [Junior Set (1st) & (2nd)]
Getting A Hug	Hmmmm ... nice. [Core Set, Party Box]
Getting A Shot	It's better than getting sick! [Junior Set (1st) & (2nd)]
Getting Head Lice	Tiny insects that live on the human scalp. Millions of children get head lice each year. [Junior Set (2nd)]
Getting Lost	Now, where did they go? [Junior Set (1st) & (2nd)]
Getting Mail	Letters, cards, magazines and packages. Is there anything for me? [Kids Set]
Getting Sick	Oh, I don't feel very good. [Kids Set]
Getting Stitches	Now they can sew you up or glue you back together. [Junior Set (2nd)]
Getting The Flu	Stay home, drink juice and watch TV. [Junior Set (2nd)]
Gettysburg, 1863	The turning point of the American Civil War, a bit more than four score and seven years ago. [Core Expansion 3, Party Box Expansion 1]
Ghost Towns	Population unknown. [Core Expansion 2, Party Box]
Ghosts	Nonmaterial embodiments or the essence of organisms (mostly human beings). Quite spirited [Core Set, Party Box]
Ghosts	A pale, shadowy form, and a favorite Halloween costume. [Junior Set (1st) & (2nd)]
GI Joe	He's an "action figure," not a "doll." [Junior Set (2nd)]
Giant Squid	Going fishing for giant squid? Nautilus I have to ... [Core Set, Party Box]
Gila Monsters	The largest, and only poisonous lizard found in the United States. [Core Expansion 2, Party Box]
Gilligan's Island	Who would have thought that you could make a radio out of coconuts. [Core Expansion 3, Party Box Expansion 1]
Ginger & Mary Ann	"Here on Gilligan's Isle." [Core Expansion 4, Party Box Expansion 1]
Gingko Trees	An Asiatic tree, Gingko biloba, known for its fan shaped leaves. We can't remember what it's good for. [Core Expansion 2, Party Box]
Ginseng	Common name for plants of the ginseng family, source of a stimulant and a supposed aphrodisiac. [Core Expansion 1, Party Box]
Giraffes	Giraffes can grow to 18 feet tall and have been known to kill a lion with a single kick. Not just another pretty face. [Core Expansion 3, Party Box Expansion 1]
Girl Scouts	I'll take six boxes of Thin Mints and three of the ... you know, the kind with the peanut butter. [Core Expansion 1, Party Box]
Girl Scouts	I will do my best to be honest and fair, friendly and helpful... and sell lots of cookies. [Junior Set (2nd)]
Girlfriends	Girlfriend - let's talk! [Core Expansion 2, Party Box]
Girlfriends	We're just friends! [Junior Set (2nd)]
Girls	"Sugar and spice and everything nice." [Kids Set]
Giving A Hug	"One may give without loving; but none can love without giving." -Anonymous [Core Set, Party Box]
Glaciers	It'll be a cold day when we see THEM again ... [Core Expansion 2, Party Box]
Glass	Glass is made by melting sand with potash or other chemicals. [Junior Set (1st) & (2nd)]
Glazed Donuts	If you're going to be late, take a box of donuts. [Core Expansion 2, Party Box]
Global Warming	Is it hot in here, or is it just me? [Core Expansion 1, Party Box]
Globes	The world at your fingertips. [Junior Set (2nd)]
Glue	Very sticky stuff! [Kids Set]
Go Karts	Go kart, go! [Core Expansion 3, Party Box Expansion 1]
Goats	Goats have short horns and beards. They'll eat anything. [Junior Set (1st) & (2nd)]
Going On A Cruise	Iceberg, dead ahead! [Core Expansion 3, Party Box Expansion 1]
Going On A Safari	Don't feed the lions! [Junior Set (2nd)]
Going On Vacation	Pack your bags! [Junior Set (2nd)]
Going To A Movie	Get some popcorn and watch the show. [Kids Set]
Going To Church	Weddings, funerals, bazaars, and bingo! [Core Expansion 2, Party Box]
Going To Grandma's	"Grandmother, what big teeth you have!" -Little Red Riding Hood [Core Expansion 1, Party Box]
Going To School	Secondary education? It's elementary. [Core Set, Party Box]
Going To School	The easiest way to get an education. [Junior Set (1st) & (2nd)]
Going To The Dentist	This won't hurt a bit ... [Core Set, Party Box]
Going To The Dentist	Have you brushed your teeth today? [Kids Set]
Going To The Gym	No pain, no gain. [Core Set, Party Box]
Gold	Rare yellow metal used to make coins and jewelry. [Kids Set]
Gold & Silver	There's a good reason Fort Knox is full of golg and not silver. [Core Expansion 4, Party Box Expansion 1]
Gold Chains	The more, the better. [Core Expansion 2, Party Box]
Goldfish	The pet, the carnival prize, or the snack cracker. [Core Expansion 2, Party Box]
Goldfish	Little orange fish that you can keep as pets. [Kids Set]
Goldie Hawn	1945- , American actor and producer. Famous for playing ditzy blondes -really well! [Core Expansion 1, Party Box]
Golf-Ball-Sized Hail	... which is almost as impressive as hail-sized golf balls ... [Core Set, Party Box]
Good & Plenty	The licorice candy was first produced in 1893, making it the oldest branded candy in the United States. [Core Expansion 4, Party Box Expansion 1]
Goose & The Gander	If it's good for the goose... [Core Expansion 4, Party Box Expansion 1]
Gorillas	Large, strong members of the monkey family. Gorillas come from Africa. [Junior Set (1st) & (2nd)]
Gossip	Petty, backbiting rumor-mongering. See also: journalism. [Core Expansion 1, Party Box]
Gourmet Coffee Shops	I'll have a tall, double cappuccino, wet, with vanilla, half decaf, - to walk. [Core Expansion 3, Party Box Expansion 1]
Grace Kelly	1929-82, Princess of Monaco and American film star of Dial M for Murder, Rear Window, and To Catch a Thief. Always chic, always elegant. [Core Expansion 2, Party Box]
Graffiti	Art in a can. We"re drawn to it. [Core Expansion 1, Party Box]
Grape Jelly	It's perfect for peanut butter and jelly sandwiches. [Junior Set (1st) & (2nd)]
Grapefruit	Not a grape, but it is a fruit. [Junior Set (2nd)]
Grapes	Small round fruit that grows in bunches, usually purple, red or green. They make good snacks! [Kids Set]
Grass Skirts	Hula loves you, baby? [Core Expansion 2, Party Box]
Grassy Hill	Good for rolling down, flying kites, and playing games. [Kids Set]
Grave Robbers	Famous for their bodies of work. [Core Expansion 1, Party Box]
Gravity	In 1684, the law of gravitation was formulated by English physicist Sir Isaac Newton, who recognized the gravity of the situation. [Core Set, Party Box]
Gravy	Sauce made from meat juices. Got to have it on mashed potatoes. [Junior Set (1st) & (2nd)]
Grease	Pretty slick! [Core Expansion 3, Party Box Expansion 1]
Grease & Grime	What would Martha do? [Core Expansion 4, Party Box Expansion 1]
Green Beans	Long, thin beans that you can eat raw or cooked. [Junior Set (1st) & (2nd)]
Greenpeace	International organization dedicated to preserving the Earth's natural resources, and its diverse plant and animal life. [Core Expansion 2, Party Box]
Grocery Stores	Good places to buy food, supplies and candy! [Kids Set]
Guitars	ROCK AND ROLL! [Junior Set (2nd)]
Gummi Bears	Little rubbery candies shaped like bears. [Kids Set]
Gym Teachers	"I am a Physical Education Teacher. Call me a gym teacher again and you can drop and give me ten!" [Core Expansion 2, Party Box]
Gymnastics	Tucks, vaults and handsprings- it's harder than it looks. [Junior Set (2nd)]
Haiku	Traditional form of Japanese poetry consisting of three lines, usually containing a reference to nature. [Core Expansion 3, Party Box Expansion 1]
Hair Transplants	Oh, it looks so natural ... [Core Expansion 2, Party Box]
Hairballs	Cough it up, kitty ... [Core Set, Party Box]
Halloween	October 31, the eve of All Saints' Day, celebrated with costumes, treats, and scary stuff. Not just for Kids Set any more! [Core Expansion 2, Party Box]
Halloween	The October 31st celebration featuring costumes, treats, and other spooky stuff. [Junior Set (2nd)]
Ham Sandwhich	Ham is pork. Pork is pig. It's a pig sandwich! [Junior Set (2nd)]
Hamburgers	Do you want fries with that? [Junior Set (1st) & (2nd)]
Hammer & Nails	"If I had a hammer..." - Peter, Paul and Mary [Core Expansion 4, Party Box Expansion 1]
Hammer & Sickle	An emblem of the Communist movement, now retired... as is the Soviet Union. [Core Expansion 4, Party Box Expansion 1]
Hammerhead Sharks	The name for these sharks comes from the unusual shape of their heads. [Junior Set (2nd)]
Hammers	"I'd rather be a hammer than a nail." [Junior Set (1st) & (2nd)]
Hamsters	These little rodents store food in their cheeks. [Junior Set (2nd)]
Hand Grenades	Close only counts in horseshoes and hand grenades! [Core Expansion 2, Party Box]
Handcuffs	"You have the right to remain silent..." [Core Set, Party Box]
Handguns	Source of a never-ending controversy as to how to get them out of the hands of the bad guys and into the hands of the good guys. [Core Expansion 1, Party Box]
Hang Gliding	Trust us. It's a breeze. [Core Expansion 3, Party Box Expansion 1]
Hangnails	We've fingered the cause of the pain. [Core Set, Party Box]
Hansel & Gretel	One of Grimm's grimmer fairy tales. [Core Expansion 4, Party Box Expansion 1]
Hanukkah	An eight day long Jewish celebration that usually occurs in December. [Kids Set]
Hard Boiled Eggs	Well, I'll be deviled . . . [Core Expansion 3, Party Box Expansion 1]
Harrison Ford	1942-, Iconic American actor. "Hokey religions and ancient weapons are no match for a blaster at your side, kid." [Core Expansion 3, Party Box Expansion 1]
Harry Potter	The hero in a series of books by J.K. Rowling featuring muggles and wizards. [Core Expansion 3, Party Box Expansion 1]
Harry Potter	The hero in a series of books by J.K. Rowling featuring wizards and muggles. [Junior Set (1st) & (2nd)]
Harvard & Yale	"What? Like it's hard?" - Reese Witherspoon, Legally Blond [Core Expansion 4, Party Box Expansion 1]
Haunted House	If there's a ghost- it's haunted! [Junior Set (2nd)]
Having A Baby	"Rock-a-bye baby, on the tree top ..." Who would put a kid on a tree top? [Core Expansion 1, Party Box]
Having A Party	Invitations, snacks, games, music... it's a party! [Junior Set (2nd)]
Having An Operation	What a cutup! A real stitch. [Core Set, Party Box]
Hawaii	The eight islands that make up America's 50th state entered the Union on August 21, 1959. [Core Set, Party Box]
Hawks & Doves	The big birds of war and peace. [Core Expansion 4, Party Box Expansion 1]
Head Lice	Head lice suck blood from the scalp and spread like crazy. A REAL parasite. [Core Expansion 3, Party Box Expansion 1]
Heart & Soul	They're yours. All yours! [Core Expansion 4, Party Box Expansion 1]
Heaven & Hell	The ups and down of the afterlife. [Core Expansion 4, Party Box Expansion 1]
Helen Keller	1880-1968, American author and lecturer who overcame deafness and blindness with the help of her companion, Anne Sullivan. [Core Set, Party Box]
Helicopters	The spinning blades keep the helicopter in the air- somehow. [Junior Set (2nd)]
Herb Gardens	Rosemary, Basil, Chive . . . is it a herb garden or the cast from a British drama? [Core Expansion 3, Party Box Expansion 1]
Here & There	And everywhere. [Core Expansion 4, Party Box Expansion 1]
Hiccups	How do you, hic, get em? How do you, hic, get rid of "em? [Core Expansion 1, Party Box]
Hiding Places	It's a secret. [Junior Set (1st) & (2nd)]
High Heels	No running. [Junior Set (2nd)]
High School	Most students start high school when they are fourteen. [Junior Set (1st) & (2nd)]
High School Football	The whole ten yards! [Core Set, Party Box]
High School Reunions	See also: "root canal, as fun as ..." [Core Expansion 1, Party Box]
Hiking In The Woods	It's an adventure. [Junior Set (1st) & (2nd)]
Hillary Rodham Clinton	1947- , New York Senator, lawyer, and former American First Lady. [Core Set, Party Box]
Hills & Valleys	Nature's little ups and down. [Core Expansion 4, Party Box Expansion 1]
Hip Hop	Musical and cultural movement that gained popularity in the 1980s. Yo, yo, yo. [Core Expansion 3, Party Box Expansion 1]
Hippopotamus	Hippos are also called "river horses" and only eat plants. [Junior Set (2nd)]
Hiroshima	1945 - "I am become death, the destroyer of worlds" - J. Robert Oppenheimer, on the detonation of the first atmoic bomb. [Core Set, Party Box]
Hit & Run	An automobile crash, or a baseball play. [Core Expansion 4, Party Box Expansion 1]
Hitting A Home-Run	Going... going... CRASH... through the neighbor's window! [Junior Set (2nd)]
HMOs	Heath Maintenance Organizations. Here's to your health ... [Core Expansion 2, Party Box]
Hockey	Did you hear about the big fight last night? All of a sudden, a hockey game broke out! [Core Set, Party Box]
Hockey	Skate! Pass! Score! [Junior Set (1st) & (2nd)]
Hollywood	Motion picture and television industry center of the world. Hooray for Hollywood! [Core Set, Party Box]
Hollywood & Vine	The Los Angeles street corner where dreams come true. [Core Expansion 4, Party Box Expansion 1]
Homeless Shelters	In the United States, nearly three-quarters of the help for the homeless comes from the private sector, mostly from church soup kitchens. [Core Expansion 2, Party Box]
Homework	Something to do during comercials. [Kids Set]
Homer Simpson	Fictional cartoon character created by Matt Groening. D'oh! [Core Set, Party Box]
Homework	Finally, something to do during commercials. [Core Set, Party Box]
Honey	A sweet, thick, gold liquid made by bees. [Junior Set (1st) & (2nd)]
Hook & Ladder Trucks	One big reason to become a firefighter. [Core Expansion 4, Party Box Expansion 1]
Hooligans	"Hey! Kids Set! Get outta my yard!" [Core Set, Party Box]
Hootie & The Blowfish	One of the most commercially successful pop bands to emerge in the 1990s. I go blind when I think about them. [Core Expansion 4, Party Box Expansion 1]
Hopscotch	All you need is a sidewalk, chalk, and a rock. [Junior Set (2nd)]
Horse & Cart	Get the order right! [Core Expansion 4, Party Box Expansion 1]
Horseback Riding	WHOAAA!!! [Core Expansion 2, Party Box]
Horses	Black Beauty, the Black Stallion, and Flicka are famous horses in literature. [Junior Set (1st) & (2nd)]
Hospital Gowns	Open all hours. [Core Expansion 3, Party Box Expansion 1]
Hospitals	The ambulance is the fastest way to get there. [Junior Set (1st) & (2nd)]
Hot Chocolate	A good drink on a cold day. Just add marshmallows! [Kids Set]
Hot Lava	There's no better way to serve it. [Core Set, Party Box]
Hot Tubs	Of course it's hot- it's a hot tub! [Junior Set (2nd)]
Hot Wheels Cars	Small, metal cars to play with and collect. They can go over 300 miles per hour downhill! [Kids Set]
Hotdogs	A sausage served at ballgames and cookouts. They are NOT made from dogs! [Kids Set]
Hotels & Motels	Get a room! [Core Expansion 4, Party Box Expansion 1]
House & Home	And money pit. [Core Expansion 4, Party Box Expansion 1]
House Guests	How many visitors does it take to drive you crazy? Go on -take a guest! [Core Expansion 1, Party Box]
Howard Stern	1954-, American shock disc jockey. His autobiography is titled Private Parts. If only they WERE private. [Core Expansion 3, Party Box Expansion 1]
Hugs	There are bear hugs, Grandma hugs, friend hugs, and love hugs. [Kids Set]
Hummingbirds	Why do hummingbirds hum? Because they don't know the words ... ... da-dum, dum! [Core Set, Party Box]
Humphrey Bogart	1899-1957, American film actor, starred in such classics as The Maltese Falcon and Casablanca. "Here's looking at you kid." [Core Set, Party Box]
Hunters	Wolves, hawks, owls, and people all hunt for food. [Junior Set (1st) & (2nd)]
Husbands & Wives	For richer... hopefully. [Core Expansion 4, Party Box Expansion 1]
Ice	Good for drinks in the summer and skating in the winter. [Junior Set (1st) & (2nd)]
Ice & Snow	"We come from the land of the ice and snow/ From the midnight sun where the hot springs blow." - Led Zeppelin [Core Expansion 4, Party Box Expansion 1]
Ice Cream	"I scream, you scream, we all scream, for ice cream!" [Kids Set]
Ice Skating	You can do fancy turns, have a race, go backwards, or just glide. [Kids Set]
Icebergs	May reach 300 to 500 feet above the oceans's surface. Ask the captain of the Titanic about the 90 percent that's UNDER water. [Core Set, Party Box]
In A Coma	A deep, prolonged state of unconsciousness ... sometimes you just feel that way. [Core Expansion 2, Party Box]
In The Attic	Old clothes, old toys, old furniture, and more old stuff. [Junior Set (2nd)]
In The Basement	You never know what you will find down there. [Kids Set]
In The Doghouse	All told, I'd rather be in the cathouse. [Core Expansion 3, Party Box Expansion 1]
Incense	Incense is better than no sense at all. [Core Expansion 1, Party Box]
Inchworm	An inchworm is actually a small, hairless caterpillar. [Junior Set (2nd)]
India	The world's seventh largest country by area, but the second most populous, with one billion people. [Core Expansion 2, Party Box]
Indiana Jones	Fictional archeologist and action hero. Proof that a good hat and a whip can take you a long way. [Core Expansion 2, Party Box]
Industrial Revolution	The first Industrial Revolution occurred in Great Britain at the end of the 1700s. The second came with the invention of the "Clapper." [Core Set, Party Box]
Infomercials	One of these days, one of them may even say something informative. [Core Set, Party Box]
Inside The Sun	Consisting mostly of hydrogen, the Junior Seterature reaches almost 16,000,000 K (about 29,000,000 F). [Core Set, Party Box]
Intellectuals	They think they're so smart. [Core Expansion 2, Party Box]
Ireland	Island of the British Isles, west of Great Britain. Known for its distinctive traditional dance and music. [Core Expansion 2, Party Box]
Irrational Fears	What's that sound? [Core Expansion 3, Party Box Expansion 1]
Israel	Located on the Mediterranean, the state of Israel was reated by a 1948 U.N. mandate. [Core Expansion 2, Party Box]
Italy	European Republic, shaped like a boot - a very fashionable boot. [Core Set, Party Box]
Itchy Clothes	Rough, prickly, scratchy - they're awful! [Kids Set]
Jack Nicholson	1937- , American motion-picture actor of "Chinatown," "Terms Of Endearment" and "The Shining." He's as good as it gets! [Core Expansion 1, Party Box]
Jack The Ripper	Accused of murdering six women in 1888, and suspected in other murders. Still at large. [Core Expansion 1, Party Box]
Jackie Chan	1954-, actor, director, martial artist. Screen name, Sing Lung, means "Becoming the Dragon." That's "MISTER Becoming the Dragon" to you! [Core Expansion 1, Party Box]
Jacques Cousteau	1910-97, French naval officer, marine explorer, and author. Best known as a documentary filmmaker. [Core Set, Party Box]
Jail	A place for keeping people who have broken the law. [Kids Set]
Jamaica	Third largest island of the Greater Antilles, south of Cuba. Tropical climate, reggae music, and jerk cooking. [Core Expansion 2, Party Box]
James Bond	Fictional British secret agent created by English author Ian Fleming. Shaken, but never stirred. [Core Set, Party Box]
James Dean	1931-55, American actor of film, stage, and television. His role in Rebel Without a Cause helped define "cool." [Core Set, Party Box]
Japan	An Asian constitutional monarchy. The capital city is Tokyo. Let's see ... sushi, Godzilla, earthquakes ... [Core Set, Party Box]
Japanese	How many Japanese does it take to screw in a light bulb? Who needs light bulbs when you've got OUR new technology! [Core Set, Party Box]
Jell-O	A solid, clear treat in lots of fruit flavors. It wiggles and jiggles! [Kids Set]
Jelly Beans	Well, as long as we HAVE to eat our vegetables ... [Core Expansion 1, Party Box]
Jelly Beans	Jelly beans are now available in 50 different flavors! [Junior Set (2nd)]
Jenna & Barbara	President Bush's daughters, the "First Twins." [Core Expansion 4, Party Box Expansion 1]
Jennifer Lopez	1970-, American singer and actor of Selena, Money Train, and Maid In Manhattan. [Core Expansion 2, Party Box]
Jerry Springer	1944- , controversial talk-show host. Don't those people know that millions of us are watching? [Core Expansion 1, Party Box]
Jesse Jackson	1941-, American civil rights leader. Named to "The Gallup List of Ten Most Respected by Americans" for ten years. [Core Expansion 1, Party Box]
Jesse Ventura	1951-, wrestler, Navy Seal, and former governor of Minnesota. Author of I Ain't Got Time To Bleed. [Core Expansion 1, Party Box]
Jim Carrey	1962- , Canadian comedian and actor. Famous for outrageous faces, and dumb and dumber characters. [Core Expansion 1, Party Box]
Jimmy Stewart	1908-97, America's favorite self-image. Mr. Smith Goes to Washington, Rear Window, Vertigo, and It's a Wonderful Life, ... and it probably was. [Core Expansion 2, Party Box]
Joan Of Arc	1412-31, patron saint of France who decisively turned the tide of the Hundred Years' War, which really burned her up. [Core Set, Party Box]
Jodie Foster	1962- , American actor began her career on Mayberry, R.F.D. and went on to win Academy Awards for The Accused and Silence Of The Lambs. [Core Expansion 2, Party Box]
John F. Kennedy	1917-63, 35th president of the US. "Ask not what your country can do for you; ask what you can do for your country." [Core Set, Party Box]
John Glenn	1921- , The first U.S. astronaut to orbit the earth in 1962, and a U.S. Senator. Never too old to shoot for the moon! [Core Expansion 2, Party Box]
John Philip Sousa	1854-1932, American bandmaster and composer of Stars and Stripes Forever. Known as "The March King." [Core Expansion 2, Party Box]
John Travolta	1954 - , American actor of "Welcome Back, Kotter," "Grease," "Saturday Night Fever" and "Pulp Fiction." That man can dance! [Core Expansion 1, Party Box]
John Wayne	1907-79, legendary American actor, "The Duke" starred in such classics as Stagecoach, The Sands of Iwo Jima and True Grit. [Core Expansion 3, Party Box Expansion 1]
Johnny Depp	1963-, American actor and heart-throb. From Cry-Baby to The Man Who Cried - he's as smooth as Chocolat. [Core Expansion 3, Party Box Expansion 1]
Jonah & The Whale	The greatest fish story ever told, in the Bible, that is. [Core Expansion 4, Party Box Expansion 1]
Judge Judy	Ms. Sheindlin presides over real-life cases on this TV courtroom show. "I'm the boss, applesauce!" [Core Expansion 2, Party Box]
Juggling	Start with two and see how you do. [Junior Set (1st) & (2nd)]
Julia Roberts	1967-, American actor and Pretty Woman. Also starred in Steel Magnolias, My Best Friend's Wedding, and Erin Brockovich. [Core Expansion 2, Party Box]
Jumping Rope	Twirl the rope and jump! [Kids Set]
Junk Mail	Contests, credit card applications, solicitations and political ads. [Core Expansion 2, Party Box]
Junkyard Dogs	Not as mean as bad, bad Leroy Brown. [Core Expansion 3, Party Box Expansion 1]
Jupiter	Story Problem: If one year on Jupiter equals 11.86 Earth years, and one day equals 9.92 Earth hours, how many Earth hours are there in a Jupiter year? [Core Expansion 2, Party Box]
Jurassic Park	1993 film based on Michael Chrichton's book about dinosaurs brought back to life, with Oscar-winning visual effects. [Core Expansion 3, Party Box Expansion 1]
Kangaroos	Large animals from Australia that hop. Mother kangaroos carry their babies in pouches. [Kids Set]
Katherine Hepburn	1909-2003, American actor and winner of four Academy Awards. She starred in such classics as The African Queen. [Core Set, Party Box]
Keanu Reeves	1964- , American actor of Bill And Ted's Excellent Adventure, The Matrix and Speed. Keanu means "cool breeze over the mountains." [Core Expansion 2, Party Box]
Kickball	You'll get a kick out of it! [Junior Set (2nd)]
Killer Whales	Black and white predatory whales. Boy, can they sing! [Core Set, Party Box]
Kilts	If Mel Gibson can wear one, so can you. [Core Expansion 2, Party Box]
Kindergarten	"A, B, C, D, E, F, G... Won't you sing along with me?" [Junior Set (2nd)]
King Arthur	Legendary British king best known for Camelot and round tables. [Core Expansion 1, Party Box]
King Henry VIII	1491-1547, King of England, and founder of the Church of England. Six wives, no waiting. [Core Set, Party Box]
King Tut	Boy king who ruled Egypt from 1333 to 1323 B.C., known for the great wealth of objects found in his tomb. He took it with him. [Core Expansion 3, Party Box Expansion 1]
Kiss & Tell	Best to keep your mouth shut. [Core Expansion 4, Party Box Expansion 1]
Kisses	Chocolate kisses are the best! [Junior Set (1st) & (2nd)]
Kittens	Baby cats, usually playful and fuzzy. Meow. [Kids Set]
Knife & Fork	Knife on the right, fork on the left. [Core Expansion 4, Party Box Expansion 1]
Knitting Needles	Knit one, pearl two . . . [Core Expansion 3, Party Box Expansion 1]
Knock-Knock Jokes	Who's there? [Core Expansion 1, Party Box]
Labor Unions	Look for the Union label. And, while you're at it, look for Jimmy Hoffa ... [Core Expansion 1, Party Box]
Lady & The Tramp	The 1955 Disney animated film featuring dogs, love and spaghetti. [Core Expansion 4, Party Box Expansion 1]
Ladybugs	Small, round red or orange beetles with black spots. They can fly! [Kids Set]
Lance Armstrong	1971-, American cyclist, cancer survivor and winner of the Tour De France - brought new meaning to the phrase "Going Postal." [Core Expansion 3, Party Box Expansion 1]
Large Mouth Bass	Oh, please, let it not sing ... [Core Expansion 2, Party Box]
Las Vegas	The first casino opened in Las Vegas in 1946. Las Vegas ... or it that Lost Wages?" [Core Set, Party Box]
Lassie	A famous collie, Lassie starred in her own TV show. What's that you say Lassie? Little Timmy's fallen down the well? [Core Expansion 3, Party Box Expansion 1]
Last Night	About last night . . . [Core Expansion 3, Party Box Expansion 1]
Last Will & Testament	It may be your only chance to get the last work on anything. [Core Expansion 4, Party Box Expansion 1]
Laurel & Hardy	Classic fat-skinny comedy duo of the 1920s. [Core Expansion 4, Party Box Expansion 1]
Laverne & Shirley	The 1970s sitcom phenomenon that defined Milwaukee for the world. And Milwaukee's still trying to live it down! [Core Expansion 4, Party Box Expansion 1]
Law & Order	The television show, or the concept. [Core Expansion 4, Party Box Expansion 1]
Lawyers	We'd throw some joke in here, but we're afraid of getting sued. [Core Set, Party Box]
Leaf Blowers	Toro, Toro, Toro! [Core Expansion 2, Party Box]
Learning Spanish	Who knows, maybe you'll need it someday. [Junior Set (2nd)]
Learning To Ski	Put on the ski boots, then the skis, then get up to the top of the hill... [Junior Set (2nd)]
Leather	Animal hide. Leather you like it or not. [Core Set, Party Box]
Leather & Lace	It's a texture thing. [Core Expansion 4, Party Box Expansion 1]
Leeches	Any mention of lawyers, agents, or reporters would be FAR too easy ... [Core Expansion 1, Party Box]
Lego Building Blocks	Get more blocks! We're building the Golden Gate Bridge. [Junior Set (2nd)]
Legs	People have them, animals have them, even tables have them. [Junior Set (2nd)]
Lemon & Lime	Pucker up. [Core Expansion 4, Party Box Expansion 1]
Lemon Meringue Pie	Tart, sweet and smooth. [Core Expansion 3, Party Box Expansion 1]
Lemonade	Needs more sugar! [Junior Set (2nd)]
Lemons	When life gives you lemons, make lemonade ... or, in the case of a car, take it back. There's a law, you know! [Core Expansion 1, Party Box]
Lemons	Sour yellow fruit. Add sugar and water and you can make lemonade! [Kids Set]
Lenin's Tomb	We'd love to visit Lenin's Tomb, but it's probably just another communist plot. [Core Expansion 2, Party Box]
Leonardo Da Vinci	1452-1519, Florentine artist, sculptor, architect, engineer, scientist, and all-around smartypants. [Core Set, Party Box]
Lethal Injection	It's a killer. [Core Expansion 3, Party Box Expansion 1]
Lewis & Clark	The early 1800s expedition covered over 8000 miles and confirmed that the Louisiana Purchase was a very good deal. [Core Expansion 4, Party Box Expansion 1]
Liberty & Justice	For all. [Core Expansion 4, Party Box Expansion 1]
Life Jackets	It won't work if you don't wear it! [Junior Set (2nd)]
Lifeguard	A person whose job it is to help and protect swimmers. [Kids Set]
Lightning	Electrical discharge between rain clouds, or between a rain cloud and the earth, or between a rain cloud and an idiot with a kite. [Core Set, Party Box]
Lightning	An electrical flash of light in the sky, usually during a rainstorm. [Kids Set]
Linguine With Clam Sauce	Pass the parmesan . . . [Core Expansion 3, Party Box Expansion 1]
Lions	King of the jungle. Roar! [Kids Set]
Lions & Tigers	And bears... [Core Expansion 4, Party Box Expansion 1]
Liposuction	Fatty tissue? That sucks . . . [Core Expansion 3, Party Box Expansion 1]
Listening To Music	Nobody's home... play it loud! [Junior Set (2nd)]
Little Brown Mice	EEEK! [Junior Set (2nd)]
Liver And Onions	An acquired taste. [Core Expansion 3, Party Box Expansion 1]
Lizards	The Komodo dragon is the largest living lizard. They can grow to over ten feet long. [Junior Set (1st) & (2nd)]
Llamas	South American animal related to the camel, raised for wool, and used as pack animals. [Junior Set (1st) & (2nd)]
Loan Sharks	As dangerous as "Jaws", but without the charisma. [Core Expansion 2, Party Box]
Lobster	Crustaceans closely related to freshwater crayfishes. Market price. [Core Set, Party Box]
Lobsters	Their large claws are actually their front pair of legs. [Junior Set (2nd)]
Local Police	They know who you are and they know where you live. [Core Expansion 2, Party Box]
Loch Ness Monster	"Nessie," the legendary beast of Loch Ness, Scotland. It must be real, they have pictures. [Core Expansion 3, Party Box Expansion 1]
Lock & Key	Quit picking on me! [Core Expansion 4, Party Box Expansion 1]
Lock & Load	It's off to war we go. [Core Expansion 4, Party Box Expansion 1]
Log Cabins	Among the many Americans born in log cabins were Preisdents Harrison, Lincoln, and Grant. Just pass the maple syrup. [Core Expansion 2, Party Box]
Lollipops	Sucker! [Core Set, Party Box]
London	Founded even before the Romans reached England's shores, now the capital of Great Britain. [Core Set, Party Box]
Long Hair	Braid it, tie it in a ponytail, or just let it fly in the wind. [Junior Set (1st) & (2nd)]
Looking For A Job	Will work for fool ... [Core Expansion 2, Party Box]
Looney Tunes	Warner Brothers cartoons featuring Porky Pig and Bugs Bunny. [Core Expansion 3, Party Box Expansion 1]
Los Angeles	LA LA Land. [Core Expansion 2, Party Box]
Losing Your Backpack	"I know I had it on the bus..." [Junior Set (2nd)]
Losing Your Job	They just didn't understand me! [Core Expansion 1, Party Box]
Love & Marriage	First comes love, then comes marriage... [Core Expansion 4, Party Box Expansion 1]
Love Letters	"Roses are red, violets are blue..." [Junior Set (2nd)]
Lox & Bagels	A deli favorite. Pass the cream cheese! [Core Expansion 4, Party Box Expansion 1]
Lucille Ball	1911-89, American actor and comedian. You love Lucy? I love Lucy. [Core Set, Party Box]
Lucy & Desi	Thirty years later and we still love Lucy. [Core Expansion 4, Party Box Expansion 1]
M & M's	Candy coated chocolates first sold in 1941. Now available in purple. [Core Expansion 4, Party Box Expansion 1]
Macaroni & Cheese	It's the easiest. [Core Expansion 4, Party Box Expansion 1]
Macaroni And Cheese	A good, hot meal that's fun to eat. [Kids Set]
Machine Guns	Automatic, rapid-fire, repeating weapons. The Gatling gun was used as early as the American Civil War. [Core Set, Party Box]
Mad Cow Disease	Degenerative brain disorder in cattle. The reason they don't know enough to come in out of the rain? [Core Expansion 1, Party Box]
Madame Curie	1867-1934, French chemist and physicist who won a Nobel Prize for her work on radiation. Fun fact: A "curie" is a unit of radioactivity. [Core Expansion 2, Party Box]
Madeline	Brave storybook character who lived in an old house in Paris that was covered in vines. [Kids Set]
Madonna	1958-, American singer, songwriter, actor, writer, and 1980s pop icon. Blond Ambition. [Core Set, Party Box]
Mae West	1892-1980, American stage and film comedian. "Too much of a good thing can be wonderful." [Core Expansion 3, Party Box Expansion 1]
Magic Tricks	Now you see it, now you don't! [Junior Set (1st) & (2nd)]
Maggots	I though it was rice. [Core Expansion 3, Party Box Expansion 1]
Magic Tricks	"Nothin' up my sleeve ..." - Bullwinkle [Core Expansion 2, Party Box]
Mahatma Gandhi	1869-1948, Indian leader and philosopher who preached nonviolence. Was assassinated for his efforts. [Core Set, Party Box]
Mail Carrier	A person who brings the mail to your house, no matter what the weather. [Kids Set]
Manhattan	I'll take Manhattan!. [Core Expansion 2, Party Box]
Maple Syrup	Made from the sweet sap of the maple tree or black maple tree, produced only in North America - a "must have" for pancakes. [Core Expansion 3, Party Box Expansion 1]
Mardi Gras	Fat Tuesday marks the final day before the Christian fast of Lent, a 40-day period of self-denial and abstinence. SO LET'S PARTY! [Core Expansion 2, Party Box]
Marilyn Monroe	1926-62, American movie star, pinup and sex symbol. Just ask the Kennedys. [Core Set, Party Box]
Marlon Brando	1924-, legendary America actor who starred in A Streetcar Named Desire and won awards for On the Waterfront and The Godfather. [Core Expansion 3, Party Box Expansion 1]
Mars	The fourth planet from the sun. Where men come from. [Core Expansion 1, Party Box]
Mark Twain	1835-1910, American writer and humorist, best known for the adventures of Tom Sawyer and Huckleberry Finn. [Core Set, Party Box]
Marriage	If love and marriage go together like a horse and carriage ... who's the horse? [Core Set, Party Box]
Martha Stewart	1941-, television personality, magazine editor, and author. Domestic arts are her stock-in-trade. [Core Set, Party Box]
Martin Luther King, Jr.	1929-68, American civil rights leader and advocate of nonviolent resistance. Was assassinated for his efforts. [Core Set, Party Box]
Martin Luther King, Jr.	He believed that everyone should have equal rights, regardless of the color of their skin. [Junior Set (1st) & (2nd)]
Mary-Kate And Ashley	The Olsen twins have been TV stars since the 1980s. They also have books and videos. [Junior Set (1st) & (2nd)]
Mashed Potatoes	Pile them up like a volcano and put butter in the middle. [Junior Set (1st) & (2nd)]
Math	Add, subtract, multiply and divide- or use a calculator! [Junior Set (1st) & (2nd)]
Matzo Balls	Soul for the chicken soup. [Core Expansion 3, Party Box Expansion 1]
Maui	Hawaiian volcanic island, 728 square feet in area. Heaven on Earth. [Core Expansion 3, Party Box Expansion 1]
Maximum Security Prison	When a regular strength prison just won't do. [Core Expansion 3, Party Box Expansion 1]
McDonald's	At a McDonald's restaurant in Mexico you can order a "hamburguesa." [Junior Set (2nd)]
Me & My Shadow	"Strolling down the avenue..." [Core Expansion 4, Party Box Expansion 1]
Meat & Potatoes	A simpler meal for a simpler time. [Core Expansion 4, Party Box Expansion 1]
Meat Cleavers	No relation to Ward, June, or the Beaver ... [Core Expansion 2, Party Box]
Meat Markets	A cut above the rest. [Core Expansion 3, Party Box Expansion 1]
Meatballs	Like meatloaf, only smaller. [Junior Set (1st) & (2nd)]
Meatloaf	Large and intimidating -the dish not the singer! [Core Expansion 1, Party Box]
Meg Ryan	1961- , American actor and girl-next-door star of When Harry Met Sally, Sleepless In Seattle, and You've Got Mail. [Core Expansion 2, Party Box]
Mel Gibson	1956-, Australian actor. Known for The Road Warrior, Braveheart and :eatha; Weapon I, II, III, IV ... [Core Expansion 1, Party Box]
Men	REAL Men. [Core Expansion 2, Party Box]
Men In Black	We're not here. You don't see us. The government did NOT send us. [Core Expansion 1, Party Box]
Mensa High IQ Society	Members have IQ's in the top 2% of the population. [Core Expansion 3, Party Box Expansion 1]
Meryl Streep	1959-, accomplished American actor, two-time Oscar winner, with over a dozen Academy Award nominations. [Core Expansion 2, Party Box]
Mexico	Federal republic in North America. The capital and largest city is Mexico City. [Core Set, Party Box]
Mexico	Country in North America, just south of the United States. Spanish is spoken in Mexico. [Junior Set (1st) & (2nd)]
Mice	"The best-laid schemes o' mice an' men ..." -Robert Burns [Core Set, Party Box]
Michael Jackson	1958-, American popular singer, dancer, and songwriter. Welcome to Neverland. [Core Set, Party Box]
Michael Jordon	1963- , American professional basketball legend, led Chicago to six world championships. No bull. [Core Set, Party Box]
Michelangelo	1475-1564, inspired Italian sculptor, architect, painter, and poet. A REAL Renaissance man. [Core Expansion 1, Party Box]
Michelle Pfeiffer	1957-, American actor whose career began with Grease 2. She'd like us to forget that but remember her Oscar nominations. [Core Set, Party Box]
Mickey & Minnie	Mouse, that is. Disney's dynamic duo. [Core Expansion 4, Party Box Expansion 1]
Mickey Mouse	Disney cartoon character, friends with Minnie Mouse and Goofy. [Kids Set]
Microsoft	A leading American software company. We'd say more but we don't want to monopolize your time ... [Core Expansion 2, Party Box]
Midlife Crisis	"Here comes your 19th nervous breakdown ..." -The Rolling Stone [Core Expansion 1, Party Box]
Midnight	Cinderella's curfew. [Junior Set (2nd)]
Migraine Headaches	Not just any headache. [Core Expansion 3, Party Box Expansion 1]
Mike Tyson	1966- , American heavyweight boxer. Lend him your ear ... [Core Set, Party Box]
Miles Davis	1926-91, innovative, influential, and respected American jazz trumpter player and band layer. [Core Expansion 1, Party Box]
Milk	Three glasses a day will give you ... the gratitude of the dairy industry. [Core Set, Party Box]
Milk & Cookies	The ultimate after-school special. [Core Expansion 4, Party Box Expansion 1]
Milk Duds	Chocolate and caramel candy balls. Tooth extractions at no extra charge! [Core Expansion 2, Party Box]
Milking A Cow	They have machines for that now. [Junior Set (2nd)]
Milwaukee	The Genuine American City. It's come along way since Laverne and Shirley. [Core Expansion 3, Party Box Expansion 1]
Miniature Golf	You don't have to be miniature to play! [Junior Set (2nd)]
Minneapolis & St. Paul	The "Twin Cities" are Minnesota's largest population center. They may be twins but you can tell the difference. [Core Expansion 4, Party Box Expansion 1]
Mirrors	And now, a moment for reflection. [Core Set, Party Box]
Mittens	"Three little kittens; they lost their mittens." [Kids Set]
Mold	Fuzzy growth produced on organic matter by several types of fungi. Particularly attracted to students' refrigerators [Core Set, Party Box]
Mom & Apple Pie	Worth fighting for. [Core Expansion 4, Party Box Expansion 1]
Mom & Pop	Hey! Maybe they should open a store! [Core Expansion 4, Party Box Expansion 1]
Mom's Cooking	Just like Mom USED to make. [Core Expansion 3, Party Box Expansion 1]
Money	"The best things in life are free/ But you can give them to the birds and bees/ Just give me money ..." -Bradford and Gordy [Core Set, Party Box]
Monitor & The Merrimac	American Civil War ironclads, first fought each other in 1862. [Core Expansion 4, Party Box Expansion 1]
Monkeys	Monkeys see . . . [Core Expansion 3, Party Box Expansion 1]
Monkeys	Monkeys are playful, intelligent mammals. They just monkey around! [Junior Set (2nd)]
Monster Trucks	Large, noisy trucks that drive over cars and crush them. [Kids Set]
Monsters	Some people think they live in closets, basements, or under beds. [Kids Set]
Moon & The Stars	You want what? [Core Expansion 4, Party Box Expansion 1]
Morticians	Why do you hang around with THOSE stiffs ...? [Core Set, Party Box]
Mosquito Bites	They just want your blood. [Junior Set (2nd)]
Mosquitoes	They suck. [Core Expansion 1, Party Box]
Motorcycles	The air in your hair and bugs in your teeth. [Core Expansion 2, Party Box]
Motorcycles	Feel the wind in your hair! Or... feel the wind on your helmet! [Junior Set (2nd)]
Mount Rushmore	Memorial carved into the side of the Black Hills in South Dakota. Heads above all other monuments. [Core Expansion 1, Party Box]
Mount Vesuvius	Italian volcano that rises above the Bay of Naples and blew its top in 79 A.D., much to Pompeii's regret. [Core Expansion 3, Party Box Expansion 1]
Mountain Bikes	What goes up the mountain must come down. [Junior Set (2nd)]
Mountains	Very high hills. Some have snow at the top, even in the summer! [Kids Set]
Mr. Potato Head	Mr. Potato Head was introduced in 1952. By now, that would be Grandpa Potato Head. [Junior Set (2nd)]
MTV	"Video killed the radio star." -The Buggles [Core Expansion 1, Party Box]
Mud	Water. Dirt. You do the math. [Core Set, Party Box]
Mud	Soft, wet, sticky, gooey, gritty, grimy dirt. [Junior Set (1st) & (2nd)]
Muddy Feet	Squish your toes! [Kids Set]
Mudslides	Chocolate drink or natural disaster ... both occur frequently in California. [Core Expansion 2, Party Box]
Muffins	"Do you know the Muffin Man?" [Junior Set (2nd)]
Muhammad Ali	1942- , American heavyweight boxing champion. "Floats like a butterfly, stings like a bee." [Core Expansion 1, Party Box]
Mushrooms	It's a fungus. [Junior Set (2nd)]
Music	Pick your favorite: country, pop, rock, rap, hip hop, jazz, or classical. [Junior Set (1st) & (2nd)]
Music Lessons	Practice, practice, practice. [Junior Set (1st) & (2nd)]
Musicals	South Pacific, The King and I, The Sound of Music, A Chorus Line, Cats, Rent ... [Core Expansion 2, Party Box]
Mustard	Made from seeds of the mustard plant. Spread on pretzels and hotdogs. [Junior Set (1st) & (2nd)]
Mutual Funds	Mutually benefits you and your broker. [Core Expansion 3, Party Box Expansion 1]
My 16th Birthday	Dad, can I have the keys to the car, please? [Core Set, Party Box]
My Baby Blanket	I don't care if it does have holes! [Junior Set (2nd)]
My Bank Account	Speaking of theoretical mathematics and unreal numbers ... [Core Set, Party Box]
My Bathroom	"The bathroom was drenched with their splashings" -Aldous Huxley [Core Set, Party Box]
My Bedroom	"No one knows what goes on behind closed doors." -Charlie Rich [Core Set, Party Box]
My Best Friend	A person you can trust, no matter what. [Junior Set (2nd)]
My Body	Mine is a Junior Setle. Specifically, the Junior Setle of Doom ... [Core Set, Party Box]
My Boss	... is an idiot. You know it; we know it. [Core Set, Party Box]
My Dad	Father, Daddy, Papa. [Kids Set]
My Dreams	"What dreams may come ..." -Shakespeare's Hamlet [Core Expansion 1, Party Box]
My Family	They'll drive you nuts. As long as you do the same to them, it's all even. [Core Set, Party Box]
My Family	Everyone's family is different. [Junior Set (1st) & (2nd)]
My Father	"Go ask your mother." [Core Expansion 3, Party Box Expansion 1]
My First Kiss	Sparks were flying. Of course, that could have been the braces ... [Core Set, Party Box]
My Friends	With friends like there, who needs enemies? [Core Expansion 2, Party Box]
My Friends	To have good friends, you have to be one. [Junior Set (1st) & (2nd)]
My Future	"The future's so bright, I gotta wear shades ..." -Timbuk-3 [Core Set, Party Box]
My Grandma	My mom or dad's mother. [Kids Set]
My Grandpa	My mom or dad's father. [Kids Set]
My Hair	Hair today, gone tomorrow ... [Core Set, Party Box]
My Hair	You can curl it, cut it, and color it! [Kids Set]
My High School Prom	As if adolescence isn't awkward and painful enough ... [Core Set, Party Box]
My Home	There's no place like home! [Kids Set]
My Job	Love it or leave it. [Core Set, Party Box]
My Life	"There are places I'll remember/ All my life/ though some have changed . . ." - The Beatles [Core Expansion 3, Party Box Expansion 1]
My Love Life	"All you need is love ..." -The Beatles [Core Set, Party Box]
My Memories	Thanks for the memories . . . [Core Expansion 3, Party Box Expansion 1]
My Mind	It's a terrible thing to waste. [Core Set, Party Box]
My Mom	Mother, Mommy, Mama. [Kids Set]
My Mother	"Go ask your father." [Core Expansion 3, Party Box Expansion 1]
My Neighborhood	"Please, won't you be my neighbor?" -Fred Rogers [Core Expansion 1, Party Box]
My Past	What's past is past ... unless you're a politician ... [Core Set, Party Box]
My Personality	"I'm good enough, smart enough and, gosh darn it, people like me." -Stewart Smalley played by Al Franken [Core Expansion 1, Party Box]
My Refrigerator	It's a science experiment! [Core Expansion 1, Party Box]
My Room	Where I sleep and keep all my things. KEEP OUT! [Kids Set]
My School	"Be true to your school." [Junior Set (1st) & (2nd)]
My Shoes	Old shoes, new shoes, red shoes, blue shoes. [Kids Set]
My Stuffed Animals	The dog's name is Lucky, the bear is Teddy, and the duck is Quacker. [Junior Set (2nd)]
My Teacher	If you can read this card, thank a teacher! [Kids Set]
My Town	Large or small, it's home. [Junior Set (2nd)]
Nail Polish	Whatever color you want. [Junior Set (2nd)]
Napoleon Bonaparte	1769-1821, Emperor of France. Met his Waterloo at the Battle of Waterloo. The name should have tipped him off ... [Core Set, Party Box]
NASA	National Aeronautics and Space Administration, established in 1958 in part in response to the U.S.S.R. launching Sputnik. [Core Expansion 3, Party Box Expansion 1]
NASCAR	Stock car racing began after World War II, breaking records for speed and for the number of advertisements on a single jacket. [Core Expansion 1, Party Box]
Nashville	Capital of Tennessee and capital of country music - also known as Nash Vegas. [Core Expansion 3, Party Box Expansion 1]
Neighbors	Turn down that music! [Junior Set (2nd)]
Neil Simon	1927-, American producer, playwright, and screenwriter of The Odd Couple, Biloxi Blues, The Sunshine Boys, California Suite, and many more. [Core Expansion 2, Party Box]
New Orleans	The Big Easy. [Core Set, Party Box]
New Shoes	Make you feel like dancing ... [Core Expansion 1, Party Box]
New York City	America's most populous city. So good, they named it twice. [Core Set, Party Box]
New York City	America's largest city, known for the Statue of Liberty. [Junior Set (1st) & (2nd)]
New Yorkers	Brash, brawny and full of bravado. [Core Expansion 3, Party Box Expansion 1]
Niagara Falls	Niagara Falls was formed about 12,000 years ago, when glaciers retreated north, and honeymooners approached from the south. [Core Expansion 1, Party Box]
Niagara Falls	The 2nd largest waterfall in the world, located on the United States border with Canada. [Junior Set (1st) & (2nd)]
Nicholas Cage	1964- , American actor known for his edgy characters in Leaving Los Vegas, Raising Arizona, and Moonstruck. [Core Expansion 2, Party Box]
Night	You can see stars and the moon in the sky. [Kids Set]
Ninjas	Teenage mutant turtles need not apply. [Core Expansion 1, Party Box]
Nirvana	A state of supreme spiritual bliss and liberation. And then there's the band . . . [Core Expansion 3, Party Box Expansion 1]
Nobel Peace Prize	Established by Alfred Nobel. Swedish industrialist and inventor of dynamite. Led to an explosion of peace efforts. [Core Expansion 1, Party Box]
Noisy Neighbors	WHAT? I CAN'T HEAR YOU! [Core Expansion 2, Party Box]
Noodles	Most noodles are made with flour, water and eggs, but some contain seaweed or spinach. [Junior Set (1st) & (2nd)]
Normal Rockwell	1894-1978, American painter, illustrator and all-around interpreter of small town American life. [Core Set, Party Box]
North & South Dakota	It's all north. [Core Expansion 4, Party Box Expansion 1]
North Pole	The northern most point on the earth, but you're not going to find a pole there. [Junior Set (1st) & (2nd)]
Nosebleeds	Keep your chin up. [Core Expansion 3, Party Box Expansion 1]
*NSYNC	Popular boy band known for their dance routines and harmonies. Bye, Bye, Bye our albums! [Core Expansion 3, Party Box Expansion 1]
Nuclear Power Plants	"You've turned a potential Chernobyl into a mere Three Mile Island." -Montgomery Burns, "The Simpsons" [Core Expansion 1, Party Box]
Nuts & Bolts	A good way to stay connected. [Core Expansion 4, Party Box Expansion 1]
NYPD	The New York Police Department. They're so good, they have their own TV show. [Core Expansion 1, Party Box]
Oatmeal	A hot cereal made from oats. It sticks to your ribs, and to the floor! [Kids Set]
Octopus	A sea animal with a soft, round body and eight long arms, called tentacles. [Junior Set (1st) & (2nd)]
Odds & Ends	It's in the junk drawer. [Core Expansion 4, Party Box Expansion 1]
Oil & Filter	Let me top that off for you. [Core Expansion 4, Party Box Expansion 1]
Oil & Vinegar	They don't mix, but we keep trying. [Core Expansion 4, Party Box Expansion 1]
Oil Spills	The American oil tanker, Exxon Valdez, went aground in Prince William Sound, Alaska, Mar. 24, 1989. Slick Move. [Core Expansion 1, Party Box]
Old Age	It looks good when you consider the alternative. [Core Expansion 3, Party Box Expansion 1]
Olive Oil	Derived from fresh ripe fruit, which contain about 20% oil. Better than "olive" the other oils. [Core Set, Party Box]
On The Roof	Come down this instant! [Junior Set (2nd)]
On-Line Shopping	Enter your credit card number now. This is a secure site ... Sure it is ... [Core Expansion 2, Party Box]
Onions	Round root vegetables with a strong smell and taste. They might make you cry! [Kids Set]
Oprah Winfrey	1954- , Television talk show host, actor and all-around American success story. [Core Set, Party Box]
Oral Surgery	You said a mouthful. [Core Expansion 2, Party Box]
Orange Juice	Sunshine in a glass! [Junior Set (2nd)]
Oranges	Face it ... nothing rhymes with orange. [Core Set, Party Box]
Oranges	Round orange fruit, often made into juice. Some oranges have navels. [Kids Set]
Ordinary People	Nothing special. [Core Expansion 3, Party Box Expansion 1]
Outer Space	Where the sun, moon, and planets are located. Maybe you'll visit there some day. [Kids Set]
Owls	Birds with large eyes and heads. They eat mice and snakes. Hoot-hoot. [Kids Set]
Oxygen	Oxygen was discovered in 1774. You'd think someone would have noticed it earlier. [Core Set, Party Box]
Pablo Picasso	1881-1973, Spanish painter and sculptor, one of the greatest artists of the 20th century. If only he could draw eyes ... [Core Set, Party Box]
Pacific Ocean	The Pacific is the largest, and deepest, ocean on Earth. [Junior Set (2nd)]
Pail & Shovel	I can dig it. [Core Expansion 4, Party Box Expansion 1]
Painting A Fence	A good way to earn some money. [Junior Set (1st) & (2nd)]
Pajamas	Clothes you sleep in. Some have feet! [Kids Set]
Pancakes	Some people call them flapjacks. [Junior Set (1st) & (2nd)]
Panda Bears	In China they're called "Xiongmao" which means giant cat bear. [Junior Set (1st) & (2nd)]
Panning For Gold	The dot-coms of the 1840s . . . [Core Expansion 3, Party Box Expansion 1]
Paper Route	It's a job. [Junior Set (2nd)]
Parachutes	Put this on your back, jump out of the plane, and pull the cord. Ready? [Junior Set (2nd)]
Parenting	The process of discovering you are becoming just like YOUR parents. [Core Set, Party Box]
Paris, France	The governmental, cultural and gastronomic capital of France. Or the world. Just ask the French. [Core Set, Party Box]
Parties	Birthday parties, slumber parties, Halloween parties. They're all fun! [Kids Set]
Paul McCartney & Wings	Life after The Beatles. [Core Expansion 4, Party Box Expansion 1]
Paying Bills	Also known as "Debt Restructuring." [Core Set, Party Box]
Paying Taxes	Death or Taxes? Do we have to choose right away? [Core Set, Party Box]
Peace & Love	Flower Power! [Core Expansion 4, Party Box Expansion 1]
Peace & Quiet	Truly appreciated during parenthood. [Core Expansion 4, Party Box Expansion 1]
Peaches	Fuzzy fruit. [Junior Set (1st) & (2nd)]
Peaches & Cream	A great complexion and a great dessert. [Core Expansion 4, Party Box Expansion 1]
Peacocks	The show-offs of the bird world. [Junior Set (2nd)]
Peanut Butter	A soft, creamy spread made from peanuts. Sometimes it sticks to the roof of your mouth. [Kids Set]
Peanut Butter & Jelly	On white bread; cut off the crusts. [Core Expansion 4, Party Box Expansion 1]
Peanuts	Peanuts are really a seed, not a pea or a nut. [Junior Set (1st) & (2nd)]
Peanuts & Popcorn	It's a crackerjack combination! [Core Expansion 4, Party Box Expansion 1]
Pearl Earrings	A good gift for Mother's Day! [Junior Set (2nd)]
Pebbles & Bamm-Bamm	The cartoon Kids Set from The Flintstones. BAM-BAM, BAM-BAM, BAM-BAM. [Core Expansion 4, Party Box Expansion 1]
Pencil & Paper	We're drawn to them! [Core Expansion 4, Party Box Expansion 1]
Pencils	Three-fourths of all pencils made in the United States are yellow. [Junior Set (1st) & (2nd)]
Penguins	Flightless, aquatic birds that reside in the Southern Hemisphere. All dressed up and no place to go. [Core Expansion 1, Party Box]
Penguins	Black and white sea birds found in Antarctica. They can't fly, but they sure can waddle. [Kids Set]
Penn & Teller	Magicians, illusionists, entertainers, and comedians. [Core Expansion 4, Party Box Expansion 1]
Pennies	Heads or tails? [Junior Set (1st) & (2nd)]
Peppers	Sweet and crunchy, or hot and spicy! [Junior Set (1st) & (2nd)]
Perfume	What's that smell? [Junior Set (2nd)]
Peter Pan	A book and movie character who could fly. He never wanted to grow up! [Kids Set]
Pez Dispensers	Collectable candy dispensers first being sold in 1952. Believe it or not, there has never been an Elvis Pez dispenser. [Core Expansion 3, Party Box Expansion 1]
Phone & Fax	Soon you won't need to leave the house at all! [Core Expansion 4, Party Box Expansion 1]
Picking Your Nose	Noses run in our family. [Core Set, Party Box]
Pickles	Dill or sweet? [Junior Set (2nd)]
Picnics	Pack up your food and a blanket, and go to your favorite park or beach. [Kids Set]
Pierced Ears	Mom, when can I get my ears pierced? [Junior Set (1st) & (2nd)]
Pigeons	Birds with small heads, short necks, stout bodies, and an incredible attraction to statues. [Core Set, Party Box]
Pigs	Domesticated mammal of the swine family. Thaaa ... thaaa ... that's all, folks! [Core Set, Party Box]
Pigs	Raised for their meat, including ham and bacon. [Junior Set (1st) & (2nd)]
Pillow Fights	He started it! [Junior Set (2nd)]
Pillows	Pillow fight! [Junior Set (1st) & (2nd)]
Pilots	"Welcome aboard. Today we'll be flying at 30,000 feet." [Junior Set (2nd)]
Pimples	Just in time for school pictures. [Junior Set (2nd)]
Piatas	Papier-mch animals filled with candy and whacked with a stick. [Junior Set (2nd)]
Pine Cones	Pine cones from Eastern White Pines can grow to eight inches in length. [Junior Set (1st) & (2nd)]
Pine Trees	Trees that stay green all year and have pinecones and needles. They smell great! [Kids Set]
Pineapple	Tropical fruit, or the less lush hand grenade. [Core Expansion 3, Party Box Expansion 1]
Pineapples	Shaped like a football, tastes like a fruit. [Junior Set (2nd)]
Pink Flamingos	Gracing America's lawns for more than 40 years - sold only in pairs. [Core Expansion 3, Party Box Expansion 1]
Pinocchio	Pinocchio was a wooden puppet who came to life. His nose grew each time he told a lie. [Junior Set (2nd)]
Pins & Needles	It's all sewed up! [Core Expansion 4, Party Box Expansion 1]
Piranha	Carnivorous fish found in rivers of South America. When you feel like a bite ... [Core Set, Party Box]
Pirates	"Yo, ho, yo, ho, a pirate's life for me ..." - Pirates of the Caribbean [Core Expansion 2, Party Box]
Pirates	People who rob ships at sea. Blackbeard was a famous pirate. [Kids Set]
Pit Bulls	Any of several crossbreeds of bulldogs with terriers. Or, several radio hosts we could mention. [Core Set, Party Box]
Pizza	Cheese, sausage, pepperoni, onions, and mushrooms. Pick your toppings! [Kids Set]
Plane Crashes	Statistically safer than driving ... unless you crash. [Core Expansion 2, Party Box]
Planting Flowers	"April showers bring May flowers." [Junior Set (1st) & (2nd)]
Plastic	Giant molecules of organic polymeric materials. Bags and bags of the stuff. [Core Set, Party Box]
Play-Doh	A colorful clay-like dough used for making shapes. [Kids Set]
Playgrounds	Some playgrounds have slides, swings, and sandboxes. [Kids Set]
Playing Checkers	A game for two using a checkerboard and 24 round game pieces. Jump, jump, jump - KING ME! [Kids Set]
Playing Chess	Has tantalized many of the world's greatest minds for almost 14 centuries. It just confuses the rest of us. [Core Set, Party Box]
Playing Golf	For stress reduction. Now, get that head down and straighten your arm! [Core Expansion 3, Party Box Expansion 1]
Pluto	The ninth planet in the Solar System, or Mickey Mouse's dog. [Junior Set (2nd)]
Poison Ivy	Itching for a walk in the woods? [Core Expansion 1, Party Box]
Poison Ivy	Contact with the leaves of this plant can cause a serious, itchy rash. [Junior Set (2nd)]
Pokemon	Cute cartoon monsters you gotta catch. What you do with them is up to you ... [Core Expansion 1, Party Box]
Pokemon	A video game, card game and television show. I like Pikachu. [Junior Set (2nd)]
Pole Vaulting	The sport where you can reach new heights. [Core Expansion 3, Party Box Expansion 1]
Pomp & Circumstance	La-de-da. [Core Expansion 4, Party Box Expansion 1]
Pond Scum	Simple organisms that carry out photosynthesis ... or spammers. [Core Set, Party Box]
Poodles	The only breed that is better groomed than their owners. [Core Expansion 2, Party Box]
Popcorn	Air poppers are for air heads ... I say bring on the butter! [Core Expansion 2, Party Box]
Popcorn	A good movie-time snack. [Kids Set]
Porcupines	Quill-bearing rodents that can leave you in a prickly situation. [Core Expansion 3, Party Box Expansion 1]
Pork & Beans	Rustle us up some grub, Cookie. [Core Expansion 4, Party Box Expansion 1]
Porsche Boxster	A two-seat, six cylander roadster - elegant design and superior drivability. [Core Expansion 2, Party Box]
Postal Workers	"Neither snow, nor rain, nor heat, nor gloom of night, stays these couriers from the swift completion of their appointed rounds." [Core Expansion 1, Party Box]
Potato Chips	Plain, sour cream and onion, ranch, or barbecue chips. [Junior Set (1st) & (2nd)]
Pounding Nails	Use a hammer and watch your fingers. [Kids Set]
Power & Glory	The spoils of war. [Core Expansion 4, Party Box Expansion 1]
Power Drills	Carpenters use them, and so do dentists. [Junior Set (2nd)]
Power Rangers	A television series about a group of teens fighting evil space aliens. [Junior Set (2nd)]
Power Tools	"More power! More power! Argh! Argh!" -Tim, the Tool Man, Taylor, "Home Improvement" [Core Expansion 1, Party Box]
President Bush	1946-, 43rd president of the United States. [Core Expansion 3, Party Box Expansion 1]
Pretzels	Pretzels were first made in Germany. Available straight, twisted, or knotted. [Junior Set (2nd)]
Pride & Prejudice	Jane Austin's 1813 classic novel expounding on the consequences of pride. [Core Expansion 4, Party Box Expansion 1]
Prince Charming	The perfect man ... mythical, of course. [Core Expansion 2, Party Box]
Prince Charming	The handsome prince who rescued Cinderella from her hard life. They lived happily ever after. [Kids Set]
Princess Di	1962-97, beloved English Princess who died in an auto crash. "Good-bye England's Rose ..." -Elton John [Core Set, Party Box]
Pro Wrestling	They're just faking it. But then, so are we. [Core Set, Party Box]
Psychiatrists	"And how do you feel about that?" [Core Expansion 2, Party Box]
Psychics	The Psychic Friends Network went bankrupt in 1997. Perhaps they should have seen it coming ... [Core Expansion 1, Party Box]
Public Radio	"Good morning . . . . . This morning . . . . . . . . . . . .we have Wolfgang . . . Amadeus Mozart . . . for your listening pleasure . . ." [Core Set, Party Box]
Puff Daddy	1971- , American rap artist. "I'll be Missing You" shot him to stardom; no pun intended. [Core Set, Party Box]
Pulling Weeds	It's either this or chemical warfare. [Core Expansion 1, Party Box]
Pulling Weeds	The job nobody likes to do. [Kids Set]
Pumping Iron	When a great weight needs to be lifted. [Core Set, Party Box]
Pumpkins	Bake it or carve it. Pumpkins are actually a fruit! [Junior Set (1st) & (2nd)]
Puppets	Finger puppets, hand puppets and string puppets. Kermit the Frog is a rod puppet. [Junior Set (1st) & (2nd)]
Puppies	Young dogs. They'll chew on your shoes and bark all night. [Kids Set]
Pushups	Exercises, a type of bra, or the ice cream treat. [Core Expansion 2, Party Box]
Pyramids	Built by ancient civilizations, found mainly in Egypt, Guatemala, Honduras, Mexico and Peru. Probably the result of some pyramid scheme. [Core Expansion 2, Party Box]
Queen Elizabeth II	1926-, Queen of the United Kingdom and Northern Ireland since 1952. Shame about the Kids Set, though . . . [Core Expansion 3, Party Box Expansion 1]
Quentin Terantino	1963- , Groundbreaking American director and actor. Nice movies, but not nearly enough blood. [Core Set, Party Box]
Quicksand	Just don't let it get you down. [Core Set, Party Box]
R & B	Rhythm and Blues. [Core Expansion 4, Party Box Expansion 1]
R & D	Research and Development. [Core Expansion 4, Party Box Expansion 1]
R & R	Rest and relaxation, recreation, or could be recuperation. [Core Expansion 4, Party Box Expansion 1]
Rabbits	Small, furry animals with long ears and short, fluffy tails. They like carrots and other vegetables. [Kids Set]
Raccoons	They come out at night. The dark fur around their eyes looks like a mask. [Kids Set]
Race Car Drivers	Start your engines! [Junior Set (2nd)]
Radios	In the 1940s, before television, families gathered together to listen to the radio. [Junior Set (1st) & (2nd)]
Raggedy Ann	a little red-headed rag doll with a triangle shaped nose. [Kids Set]
Ragweed	A weed of the genus Ambrosia. Nothing to sneeze at. [Core Expansion 2, Party Box]
Rain	"When the rain comes, they run and hide their heads; they might as well be dead." -The Beatles [Core Set, Party Box]
Rain	"Rain, rain, go away, come again another day." [Junior Set (1st) & (2nd)]
Rain Forests	There is heavy rainfall throughout the year and lots of bugs. [Junior Set (2nd)]
Rainbows	"Someday they'll find it/ The Rainbow Connection/ The lovers, the dreamers and me ..." -Kermit the Frog [Core Expansion 1, Party Box]
Rainbows	There are seven colors in a rainbow: red, orange, yellow, green, blue, indigo, and violet. [Junior Set (1st) & (2nd)]
Raisins	They're just dried grapes. [Junior Set (2nd)]
Raking Leaves	Maybe they'll all just blow away! [Junior Set (2nd)]
Ramona	Main character in Beverly Cleary's "Ramona the Pest" and other books in the series. [Junior Set (1st) & (2nd)]
Rap Music	Rap is a popular form of music with a strong beat and rhyming lyrics. [Junior Set (2nd)]
Rappers	PAENTAL ADVISORY EXPLICIT CONTENT Hasn't seemed to hurt sales... [Core Set, Party Box]
Rats	Gray or brown animals that look like very large mice. Usually pet rats are white. [Kids Set]
Raves	Neo-psychadelic all-night dance parties centered around acid house and techno music. All the rave. [Core Expansion 3, Party Box Expansion 1]
Reading & Writing	Old-fashioned skill, amazingly still useful today. [Core Expansion 4, Party Box Expansion 1]
Reading A Book	A good book is like traveling to a new world. [Kids Set]
Reading A Good Book	So many books, so little time. [Core Expansion 1, Party Box]
Recess	My favorite subject in school! [Kids Set]
Recreational Vehicles	If they're trying to get away from it all, why are they taking it all with them? [Core Expansion 1, Party Box]
Recycling	More than one million tons of aluminum are NOT recycled each year. Where do you throw your cans? [Core Expansion 1, Party Box]
Red Raspberries	Worth a few scratches. [Core Expansion 2, Party Box]
Red Roses	Red roses are a symbol of love. [Junior Set (1st) & (2nd)]
Rednecks	"You might be a redneck if ..." -Jeff Foxworthy [Core Expansion 1, Party Box]
Redwood Forests	"From the Redwood Forests to the Gulf Stream Waters/ This land was made for you and me." -Woody Guthrie [Core Set, Party Box]
Reggae Music	This conJunior Setorary Caribbean music, originating in Jamaica, remains an influential style of popular music. Ya mon! [Core Expansion 1, Party Box]
Regis & ...	Kathy Lee or Kelly - your choice. [Core Expansion 4, Party Box Expansion 1]
Regis Philbin	1934- , American talk and game show host. Who wants to be a millionaire? Regis, apparently. [Core Expansion 1, Party Box]
Remote Controls	The world's handiest invention. That is, if you can find it. [Core Set, Party Box]
Republicans	A U.S. political party symbolized by an elephant ... and don't forget it! [Core Set, Party Box]
Restaurants	It's good to try new things! [Junior Set (2nd)]
Rice	A grain grown for food. Rice can be white, brown or black. [Junior Set (1st) & (2nd)]
Rice & Beans	South-of-the-border meat & potatoes. [Core Expansion 4, Party Box Expansion 1]
Rice Krispies Treats	How could you go wrong with Rice Krispies, marshmallows, and butter. [Core Expansion 3, Party Box Expansion 1]
Richard Nixon	1913-94, 37th President of the United States and the only president to have resigned from office. At least that's what the tapes say ... [Core Expansion 2, Party Box]
Richard Simmons	1948-, American fitness guru famous for his extroverted style, short shorts and Sweatin' to the Oldies. [Core Expansion 3, Party Box Expansion 1]
Riding A Bike	Remember to wear your helmet. [Kids Set]
Riding A Horse	Grab the reins and hang on! [Kids Set]
Riding A Scooter	Where are the brakes? [Junior Set (2nd)]
Rio De Janeiro	Vibrant Brazilian city and home to Carnival. Blame it on Rio! [Core Expansion 3, Party Box Expansion 1]
Rivers	Can you spell Mississippi? [Kids Set]
Road Kill	Mmmmmm. Them's good eatin'. [Core Expansion 1, Party Box]
Road Rage	Ten years ago we complained about potholes. NOW we're dodging pot-shots. [Core Expansion 3, Party Box Expansion 1]
Road Trips	"Get Your Kicks on Route 66." -Nelson Riddle [Core Expansion 1, Party Box]
Robert DeNiro	1943- , Pre-eminent American actor who earned Academy Awards for The Godfather II and Raging Bull. "Are you looking at me?" [Core Expansion 2, Party Box]
Robin Hood	Legendary British outlaw who stole from the rich and gave to the poor, known for his courage, skill, and Merry Men. [Core Expansion 3, Party Box Expansion 1]
Robin Williams	1952- , versatile American comedian and actor. The furriest man in show business. [Core Set, Party Box]
Robots	They should make a robot that does homework. [Junior Set (1st) & (2nd)]
Rock & Roll	It'll never die. Unlike Rock and Roll musicians. [Core Expansion 4, Party Box Expansion 1]
Rock Candy	Large, clear sugar crystals- rock hard! [Junior Set (2nd)]
Rock Concert	If it's too loud - you're too old. [Core Set, Party Box]
Rock Concerts	Not on a school night! [Junior Set (2nd)]
Rock Stars	Even the guys wear make-up! [Junior Set (2nd)]
Rocket Scientists	Hey! They're not rocket scie ... oh ... never mind. [Core Expansion 1, Party Box]
Rocking Chairs	Rock-a-bye baby. [Junior Set (1st) & (2nd)]
Rocks	Rock collectors are sometimes called rockhounds. [Junior Set (1st) & (2nd)]
Rocky Mountains	These extend 2,000 miles from northeastern British Columbia to central New Mexico, and keep the Californians away from everyone else ... [Core Expansion 1, Party Box]
Rod & Reel	He took it hook, line, and sinker. [Core Expansion 4, Party Box Expansion 1]
Rogers & Hammerstein	Kings of the Broadway Musical: The Sound of Music, The King and I, South Pacific, and many, many more. [Core Expansion 4, Party Box Expansion 1]
Roller Coaster	Roller coaster cars can go more than 70 miles per hour. [Junior Set (1st) & (2nd)]
Rollerblading	Faster than walking. [Junior Set (1st) & (2nd)]
Rolling The Car	You'll flip for this one ... [Core Expansion 2, Party Box]
Roman Numerals	There's a I in VII chance you'll know them. [Core Expansion 2, Party Box]
Romeo And Juliet	William Shakespeare's best known play, written in 1595. Youthful love and hasty Junior Seteraments. [Core Expansion 2, Party Box]
Ronald McDonald	The clown from McDonald's restaurants. [Kids Set]
Roosters	The barnyard alarm clock. [Junior Set (2nd)]
Root Beer	A sweet, brown drink that is fizzy and foamy. Add ice cream to make a root beer float! [Kids Set]
Root Beer Floats	Actually, it's the ice cream that floats! [Core Expansion 1, Party Box]
Rope Burns	You were playing WHAT? [Core Expansion 3, Party Box Expansion 1]
Rosa Parks	1913-, civil rights icon arrested in 1956 for violating U.S. segregation laws by refusing to give up her bus seat to a white passenger. [Core Expansion 1, Party Box]
Rosie O'Donnell	1962-, American actor and comedian. She's in a league of her own! [Core Expansion 1, Party Box]
Rubber Gloves	Just in case ... [Core Expansion 2, Party Box]
Rugrats	A cartoon about the adventures of Tommy, Chucky, Angelica, and Phil and Lil. [Kids Set]
Running A Marathon	26 miles, 385 yards: the distance run by a Greek soldier from the town of Marathon to Athens in 490 BC. [Core Set, Party Box]
Running In A Race	A marathon is a 26 mile race. [Junior Set (1st) & (2nd)]
Rush Limbaugh	1951- , conservative talk-radio personality. Claims to host his radio show with half his brain tied behind his back, just to make it fair. [Core Expansion 1, Party Box]
Russia	The world's largest country, spanning 11 time zones. Famous for borscht, ballet, chess and vodka -just don't mix them. [Core Expansion 1, Party Box]
Rust	"Rust never sleeps." -Neil Young [Core Set, Party Box]
Rusty Nails	Good name for a country western singer. [Core Expansion 3, Party Box Expansion 1]
Saddam Hussein	1937-, dictator of Iraq 1979-2003. [Core Set, Party Box]
Sailors	"In the Navy, you can sail the seven seas ..." -The Village People [Core Expansion 1, Party Box]
Sailors	Get seasick? Don't become a sailor. [Junior Set (2nd)]
Salads	Lettuce not knock the vegetarians. [Core Expansion 2, Party Box]
Salads	Fruit salads, pasta salads, potato salads, and lettuce salads. [Junior Set (1st) & (2nd)]
Salsa Dancing	Popular form of Latin American dance. A little jazz, a little blues, a touch of rock and lots of heat. [Core Expansion 2, Party Box]
Salt	In ancient times salt was valuable. In fact, it was used as money. [Junior Set (1st) & (2nd)]
Salt 'N Pepa	Extremely successful rap group formed in the 1980s, known for their portrayals of the woman's perspective on relationships. [Core Expansion 4, Party Box Expansion 1]
Salt & Pepper	"Pump it up a notch! BAM!" - Emeril Lagasse. [Core Expansion 4, Party Box Expansion 1]
Salvador Dali	1904-89, Spansih artist best known for his dream imagery and surrealism, including the limp watches in The Persistence Of Memory. [Core Expansion 2, Party Box]
Samuel L. Jackson	1948-, powerful American actor of Pulp Fiction, Jackie Brown, and The Negotiator. [Core Expansion 2, Party Box]
San Francisco	California's City by the Bay. Where many hearts are left. [Core Set, Party Box]
Sand	The desert, the dunes, the beach, and in your shoes. [Junior Set (1st) & (2nd)]
Sand & Surf	Life's a beach! [Core Expansion 4, Party Box Expansion 1]
Sand Castles	No dogs allowed. [Junior Set (2nd)]
Sandra Bullock	1964-, American actor who starred in Speed, Miss Congeniality, and While You Were Sleeping. The classic girl-next-door. [Core Expansion 3, Party Box Expansion 1]
Saturday Cartoons	Get your blanket, a bowl of cereal and snuggle in for three hours of commercials. [Core Expansion 1, Party Box]
Saturn	Sixth planet from the sun, and the second largest in the solar system. Has a nice ring to it, don't you think? [Core Set, Party Box]
Scavenger Hunt	OK Kids Set, here's your list: a marshmallow, a safety pin, a red rubber band, and a moon rock. Go find 'em! [Core Expansion 1, Party Box]
Scene Of The Crime	It was Colonel Mustard, in the library, with the candlestick. [Core Set, Party Box]
Scented Candles	You didn't have to BAKE an apple pie - just light a candle. [Core Expansion 3, Party Box Expansion 1]
Schindler's List	1993 Steven Spielberg film. Powerful real-life story of a Catholic businessman who eventually saved over 1000 Jews in Nazi Poland. [Core Expansion 2, Party Box]
School Buses	Large, yellow buses used to take children to school. [Kids Set]
School Lunch	Hot lunch, cold lunch, or bring your own lunch. [Junior Set (1st) & (2nd)]
School Pictures	How do I look? [Junior Set (2nd)]
Science Experiments	Your science experiment? I thought it was dinner! [Junior Set (2nd)]
Science Fair Projects	No human subjects, please! [Core Expansion 1, Party Box]
Science Fiction	In a galaxy far, far away ... [Core Expansion 1, Party Box]
Science Tests	Multiple choice or essay. [Junior Set (2nd)]
Scientists	Scientists study astronomy, biology, chemistry, geology, and other stuff. [Junior Set (1st) & (2nd)]
Scooby-Doo	TV cartoon dog who helps solve crimes. "Scooby-Doo, where are you?" [Junior Set (1st) & (2nd)]
Screaming	NOT SO LOUD! [Kids Set]
Screeching	Please stop. [Core Expansion 1, Party Box]
Sean Connery	1930- , Accomplished Scottish actor, although best known as the REAL Bond, JAMES Bond ... [Core Set, Party Box]
Seashells	The outer shells of sea animals. You can find them on the beach. [Kids Set]
Sesame Street	Children's television show featuring Big Bird. "Can you tell me how to get to Sesame Street?" [Kids Set]
Shake & Bake	... and eat. [Core Expansion 4, Party Box Expansion 1]
Shania Twain	1965- , Canadian country singer and songwriter. "Shania" means "I'm on my way" in Ojibwa. [Core Expansion 1, Party Box]
Sharks	Many species living today are similar to those from 100 million years ago. Because change is scary. [Core Set, Party Box]
Sharks	Meat-eating fish known for their speed, sharp teeth, and the large fins on their backs. [Kids Set]
Sharp Knives	Found in kitchen drawers, tackle boxes and butcher shops. [Junior Set (2nd)]
Shave & A Haircut	Two bits. [Core Expansion 4, Party Box Expansion 1]
Ships	Battleships, cruise ships, freighters, and oil tankers. [Junior Set (1st) & (2nd)]
Shipwrecks	"The lake it is said never gives up her dead . . ." - The Wreck of the Edmund Fitzgerald" [Core Expansion 3, Party Box Expansion 1]
Shoplifting	It's stealing and it's against the law. [Junior Set (2nd)]
Shopping	It's shopping-whether you buy something or not. [Junior Set (2nd)]
Shopping Mall	Three-quarters of the North American population visit a shopping mall at least once a month. [Core Expansion 1, Party Box]
Shrimp	Tiny to jumbo- they come in all sizes. [Junior Set (2nd)]
Sigmund Freud	1856-1939, Viennese psychologist and the originator of psychoanalysis and the Freudian slip. [Core Expansion 3, Party Box Expansion 1]
Silk	Produced as a cocoon covering by the silk worm, and used in fine fabrics and textiles. [Core Set, Party Box]
Silly Putty	It's putty in your hands! [Core Expansion 2, Party Box]
Sin & Redemption	Everybody deserves a second chance. [Core Expansion 4, Party Box Expansion 1]
Singing	Making music with your voice. La-la-la. [Kids Set]
Sisters	Sister, sister! [Junior Set (1st) & (2nd)]
Sitcoms	If they're so funny, WHY THE LAUGH TRACK? [Core Expansion 3, Party Box Expansion 1]
Skateboarding	It's just going downhill ... down stairs ... down ramps ... [Core Set, Party Box]
Skateboards	"Skateboarding is not a crime!" [Junior Set (1st) & (2nd)]
Skeletons	There are 206 bones in the human body. Count them! [Junior Set (2nd)]
Skiing	The Super Ginat Slalom: Swiss for "suicide." [Core Set, Party Box]
Skin & Bones	What would you be without them? [Core Expansion 4, Party Box Expansion 1]
Skinheads	Shaved heads, big boots. Some are Nazis, some are not. [Core Set, Party Box]
Skinned Knees	Ouch! Ouch! OUCH! [Junior Set (1st) & (2nd)]
Skunks	Black and white striped mammals known for their offensive smelling defensive spray. [Core Expansion 2, Party Box]
Skunks	Black, bushy-tailed animals with one or two white stripes down their backs. Stinky! [Kids Set]
Skydiving	Parachute canopies are usually made from nylon fabric that lasts for thousands of jumps - whether the skydiver does or not. [Core Set, Party Box]
Slash & Burn	And there goes another rain forest... [Core Expansion 4, Party Box Expansion 1]
Slasher Films	A real nightmare. [Core Expansion 3, Party Box Expansion 1]
Sledding	It would be more fun if you didn't have to climb back up the hill. [Kids Set]
Sleep	"Don't let the bedbugs bite." [Kids Set]
Sleeping Pills	I remember taking them ... I just ... don"t rememmer ... how mamy. [Core Expansion 1, Party Box]
Sleepovers	If you don't sleep, is it still a sleepover? [Junior Set (1st) & (2nd)]
Slice & Dice	A sharp knife is a safe knife. [Core Expansion 4, Party Box Expansion 1]
Slip & Fall	Watch out for ... too late! [Core Expansion 4, Party Box Expansion 1]
Slivers	Also known as splinters. The worst ones are under your fingernails. [Core Expansion 1, Party Box]
Slobodan Milosevic	1941-, former leader of Serbia, also known as "the Butcher of the Balkans." [Core Expansion 3, Party Box Expansion 1]
Sloppy Joes	My favorite recipe -open the can. [Core Expansion 1, Party Box]
Smith & Wesson	Firearms when ready! [Core Expansion 4, Party Box Expansion 1]
Smithsonian Institution	Located in Washington, D.C., the largest museum complex in the world. Wouldn't that be a great garage sale? [Core Expansion 2, Party Box]
Smoke	"Where there's smoke, there's fire!" [Kids Set]
Smoke & Mirrors	That's how we do it! [Core Expansion 4, Party Box Expansion 1]
Snakes	Surprising, snakes move rapidly without legs. Also surprising, they find OTHER snakes attractive. [Core Set, Party Box]
Snakes	Long, thin reptiles without arms or legs. Their forked tongues are used for smelling. [Kids Set]
Sneezing	Ah-ah-ah-choo! [Junior Set (1st) & (2nd)]
Snips & Snails	And puppy dog tails. [Core Expansion 4, Party Box Expansion 1]
Snoopy	The little, white beagle from the "Peanuts" cartoon. [Kids Set]
Snoopy & The Red Barron	Characters in the Peanuts comic strip. Talk about a dog fight! [Core Expansion 4, Party Box Expansion 1]
Snow	Transparent ice crystals which form around dust and other small particles. Get my drift? [Core Set, Party Box]
Snow Cones	You don't have to wait for snow. [Junior Set (1st) & (2nd)]
Snow White	"Mirror, mirror, on the wall, who is the fairest of them all?" [Kids Set]
Snowballs	Just right for throwing! [Kids Set]
Snowboarding	Snowboarding was declared an official Olympic sport in 1994. [Junior Set (2nd)]
Snowflakes	They say each one is different, but who would know? [Junior Set (2nd)]
Snowstorm	Lots of snow blowing around. Maybe school will be closed! [Kids Set]
Soccer	A favorite team sport for Kids Set. KICK IT! [Kids Set]
Social Security	American program designed to provide income and services in the event of retirement, sickness, disability, death or unemployment. [Core Expansion 2, Party Box]
Socks	"Black socks, they never get dirty, the longer you wear them the stronger they get." -Bill Harley [Core Set, Party Box]
Soldiers	Men and women who serve in the military. [Junior Set (1st) & (2nd)]
South Africa	Two oceans, rugged mountains, traditional villages, game sanctuaries, wineries...forget the past and bring on the tourists. [Core Set, Party Box]
South Park	Highly-rated, highly offensive animated cartoon series. "Oh my God! We killed Kenny!" [Core Expansion 2, Party Box]
Soy Sauce	A brewed seasoning made from soybeans, wheat, and salt. [Core Expansion 2, Party Box]
Space & Time	Infinite. [Core Expansion 4, Party Box Expansion 1]
Spaghetti	Looks like a plate of worms! [Kids Set]
Spam	Mystery meat, or mystery E-mails ... [Core Expansion 1, Party Box]
Sparklers	They're still fireworks! [Junior Set (2nd)]
Speeding Tickets	"No, officer, I don't have any idea how fast I was going." [Core Expansion 1, Party Box]
Spelling Bees	Spelling contests. They have nothing to do with bees. [Junior Set (1st) & (2nd)]
Spider-Man	He's a student. He's a superhuman crime fighter. He's Spider-Man! [Junior Set (2nd)]
Spiders	There are more than 34,000 species of spiders. Try not to think about THAT right before bedtime. [Core Set, Party Box]
Spiders	They have eight legs and they spin webs to catch their food. [Kids Set]
Spiders & Snakes	Creepy! Legs or no legs. [Core Expansion 4, Party Box Expansion 1]
Spike Lee	1957-, American film maker and Knicks fan. Best known for Do the Right Thing, Malcolm X, and 4 Little Girls. [Core Set, Party Box]
Spilled Milk	Got milk? WHOOPS! Apparently not ... [Core Expansion 2, Party Box]
Spinach	Raw or cooked- it's full of vitamins. [Junior Set (2nd)]
Spit	Ladies and gentlemen, straight from the Salivary Glands ... [Core Set, Party Box]
Spit	Spit that gum out right now! [Kids Set]
Spit & Polish	We could do with less spit and more polish. [Core Expansion 4, Party Box Expansion 1]
Spontaneous Combustion	The ignition of substances without application of an external heat source. A good plot for "The X-Files." [Core Expansion 1, Party Box]
Sport Utility Vehicles	Need new tires? [Core Expansion 2, Party Box]
Sports Channels	Any team, any time. [Core Expansion 2, Party Box]
Square Dancing	"Swing your partner!" [Junior Set (2nd)]
Squirrels	Small animals with big brown eyes and bushy tails. They like nuts and can run on telephone lines. [Kids Set]
Stalactites & Stalagmites	The ups and downs of spelunking. [Core Expansion 4, Party Box Expansion 1]
Stamp Collecting	If you can't lick 'em, collect 'em. [Core Expansion 3, Party Box Expansion 1]
Stanley & Livingston	Britons who explored Africa, I presume. [Core Expansion 4, Party Box Expansion 1]
Star Fruit	Looks like plastic, tastes like lemons. [Core Expansion 2, Party Box]
Starry Night	A sky bright with stars, a classic Van Gogh painting, and a Don McLean song. Three cards in one! [Core Expansion 1, Party Box]
Stars & Stripes	Three cheers for the red, white, and blue! [Core Expansion 4, Party Box Expansion 1]
Starfish	A star-shaped sea creature with five or more arms. If one breaks off, another arm will grow. [Junior Set (1st) & (2nd)]
Stars	Points of sparkling light that you can see in the night sky. Make a wish! [Kids Set]
State Fair	Aw, gee whiz, a blue ribbon for Bessie! [Core Expansion 2, Party Box]
Steak And Potatoes	Hot off the grill! [Core Expansion 2, Party Box]
Stephen King	1947- , American author of horror novels, who's sold more than 100 million copies of his books. Talk about frightening ... [Core Set, Party Box]
Steve Martin	1945- , American comedian, actor, writer, and "wild and crazy guy." [Core Expansion 1, Party Box]
Steven Spielberg	1947-, American movie director and producer, and overachiever. From E.T. to Schindler's List... too many to list. [Core Set, Party Box]
Sticks & Stones	When words are not enough. [Core Expansion 4, Party Box Expansion 1]
Stocks & Bonds	At least they're worth the paper they're printed on... We hope. [Core Expansion 4, Party Box Expansion 1]
Stomach Ache	You ate the whole thing? [Junior Set (2nd)]
Stonehenge	Prehistoric stone monument located north of Salisbury, England. [Core Expansion 1, Party Box]
Stop Signs	Gee, Officer, I THOUGHT it was green! [Core Expansion 3, Party Box Expansion 1]
Strained Peas	The strain comes when you have to eat them. [Core Expansion 3, Party Box Expansion 1]
Strawberries	Strawberry shortcake! [Junior Set (2nd)]
Strawberry Shortcake	Summertime and the eating is easy ... [Core Expansion 2, Party Box]
Street Mimes	A mime is a terrible thing to waste. On second thought . . . [Core Expansion 3, Party Box Expansion 1]
Stretch Limos	Stretch your legs, stretch your wallet. [Core Expansion 3, Party Box Expansion 1]
Strip Malls	Almost as attractive as stip mines. [Core Expansion 3, Party Box Expansion 1]
Stuart Little	A clever little mouse who is a character in a book and a movie. [Kids Set]
Stubbed Toes	It'll feel better when it quits hurting. [Core Expansion 2, Party Box]
Stunt People	When you need someone to take the fall. [Core Expansion 2, Party Box]
Substitute Teachers	"Ms. Jones lets us eat candy and get drinks whenever we want!" [Junior Set (2nd)]
Sugar & Spice	And everything nice. [Core Expansion 4, Party Box Expansion 1]
Suit & Tie	It's business as usual! [Core Expansion 4, Party Box Expansion 1]
Summer	SCHOOL'S OUT! [Kids Set]
Summer Camp	If the bugs don't get you, the poison ivy will! [Core Expansion 1, Party Box]
Summer Camp	Day camps and sleepover camps. Either way, you'll have lots of fun. [Kids Set]
Sumo Wrestlers	Wrestlers usually weigh 300-400 pounds and win this Japanese form of wrestling by forcing an opponent out of the ring. [Core Expansion 3, Party Box Expansion 1]
Sunburns	Next time, use some sunscreen. [Junior Set (1st) & (2nd)]
Sunday Drivers	Now available ANY day of the week! [Core Expansion 1, Party Box]
Sunflower	Tall plants with large, yellow flowers. Toast the seeds for a tasty snack. [Kids Set]
Sugar	"Sugar is sweet and so are you." [Junior Set (2nd)]
Sunken Ships	Early ships would often sink in battles or bad weather. [Junior Set (2nd)]
Sunshine	Warms the Earth and helps plants to grow. [Kids Set]
Superman	Fictional comic book superhero loved by Lois Lane and Jerry Seinfeld. [Core Set, Party Box]
Superman	Faster than a speeding bullet! [Junior Set (1st) & (2nd)]
Supermarkets	It's a meat market, bakery, flower shop, and toy store- all in one! [Junior Set (2nd)]
Supermodels	Long legs = big bucks. [Core Expansion 2, Party Box]
Surf & Turf	Steak and lobster. No need to choose. [Core Expansion 4, Party Box Expansion 1]
Surfing	The waves or the web. [Junior Set (2nd)]
Surfing The Net	www.otb-games.com [Core Set, Party Box]
Surprise Parties	SURPRISE! Oh. He had a heart condition . . . that WAS a surprise . . . [Core Expansion 3, Party Box Expansion 1]
Surprise Parties	Everybody hide! [Junior Set (2nd)]
Sushi	Who would ever have guessed that raw fish could be so fashionable? [Core Expansion 2, Party Box]
Swamps	Wet, spongy land, often covered with water. A great place to live- if you're a mosquito. [Junior Set (2nd)]
Swans	The "Ugly Duckling" was actually a baby swan. [Junior Set (2nd)]
Swimming	A great way to cool down on a hot summer day! [Kids Set]
Swiss Bank Accounts	Do you think everyone in Switzerland has one? [Core Expansion 1, Party Box]
Swiss Cheese	Guess it comes from holey cows ... [Core Expansion 2, Party Box]
Swiss Chocolate	"What use are cartridges in battle? I always carry chocolate instead." -George Bernard Shaw [Core Set, Party Box]
Swordfighting	As a sport, sword fighting is called "Fencing." It is an Olympic event. [Junior Set (2nd)]
Tacos	Meat, cheese, and hot sauce all wrapped up in a tortilla. [Junior Set (2nd)]
Taking A Bath	Bathing facilities have been found in excavations in India from before 2000 BC. Soap-on-a-Rope hasn't. [Core Set, Party Box]
Taking A Bath	Don't Forget the bubbles and toys. [Kids Set]
Taking A Shower	That'll wake you up. [Junior Set (2nd)]
Talk Radio	Talk about air pollution. [Core Expansion 2, Party Box]
Tarred & Feathered	It's a sticky situation. [Core Expansion 4, Party Box Expansion 1]
Tarzan & Jane	He went ape over her. [Core Expansion 4, Party Box Expansion 1]
Tattoo Parlors	"With nothing to show but this brand new tattoo . . . how I got it here I haven't a clue." - Jimmy Buffett [Core Expansion 3, Party Box Expansion 1]
Tattoos	Tattoos can be painful. Junior Setorary tatoos don't hurt at all. [Junior Set (2nd)]
Tea & Crumpets	Upper-crust toast & jelly. [Core Expansion 4, Party Box Expansion 1]
Teachers	If you can play this game, thank a teacher. [Core Set, Party Box]
Teachers	"What do you mean, you didn't know there was a test today?" [Junior Set (1st) & (2nd)]
Teenagers	Ages thirteen to nineteen. [Junior Set (1st) & (2nd)]
Teeth	Adults have 32 permanent teeth. [Junior Set (1st) & (2nd)]
Telemarketers	"No, thank you ... No, I'm not interested ... No, I have to go now ..." [Core Expansion 1, Party Box]
Teletubbies	Colorful characters with televisions in their stomachs. Tinky Winky is purple. [Kids Set]
Televangelists	Not to be confused with Teletubbies. [Core Expansion 1, Party Box]
Television	One-hundred and sixty-four channels, and nothing worth watching. [Core Set, Party Box]
Television	If you get your homework done... [Junior Set (2nd)]
Telling Scary Stories	"It was a dark and stormy night . . ." [Junior Set (1st) & (2nd)]
Telling The Truth	"There are two kinds of truth. There are real truths and there are made-up truths." -Marion Barry, ex-mayor of Washington, D.C. [Core Expansion 2, Party Box]
Tents	A pup tent will hold one or two people, but a circus tent can hold hundreds. [Junior Set (1st) & (2nd)]
Terrorist Attack	We will never negotiate with terrorists. [Core Set, Party Box]
Texas	Famous for oil wells, barbecues, and cowboys. The capital of Texas is Austin. [Junior Set (2nd)]
Thanksgiving Day	The fourth Thursday of November in the U.S.; the second Monday in October in Canada. [Core Set, Party Box]
Thanksgiving Day	A harvest festival celebrated on the fourth Thursday in November in the U.S. [Junior Set (1st) & (2nd)]
The 1920s	Pros: the Jazz Age. Cons: Presidents who look like librarians. [Core Set, Party Box]
The 1950s	Pros: Barbies, barbecues, and bikinis. Cons: McCarthy, the Korean War, television. [Core Set, Party Box]
The 1960s	Pros: the Moon Lsnding, the music. Cons: hippies who refuse to believe they're over. [Core Set, Party Box]
The 1970s	Pros ... uh ... pros ... uh ... GIVE US A MINUTE, OKAY? [Core Set, Party Box]
The 1980s	Pros: meant the end of the 1970s. Cons: '80s nostalgia. [Core Set, Party Box]
The 1990s	Dot-coms, Clinton and designer coffee. The good old days. [Core Expansion 3, Party Box Expansion 1]
The 21st Century	The future is NOW! [Core Set, Party Box]
The Academy Awards	The statue known as "Oscar" weighs only eight and a half pounds. So why does it carry so much weight? [Core Set, Party Box]
The Atlantic & Pacific	Oceans apart. [Core Expansion 4, Party Box Expansion 1]
The Baby-Sitters Club	This series of books, written by Ann M. Martin, is a favorite of girls, world-wide. [Junior Set (2nd)]
The Beach	A day at the beach is no day at the beach, ya know? [Core Set, Party Box]
The Beach	Sun, surf, and sand. [Junior Set (1st) & (2nd)]
The Beatles	1960s British band. Only the most revolutionary, influential and universally acclaimed group of the 20th century. That's all. [Core Set, Party Box]
The Big Dipper	Group of stars in the Northern sky that form part of the constellation Ursa Major. [Core Expansion 3, Party Box Expansion 1]
The Birds & The Bees	We'll tell you about them sometime. [Core Expansion 4, Party Box Expansion 1]
The Chicken & The Egg	Which came first? The egg. Look it up! [Core Expansion 4, Party Box Expansion 1]
The Chicken Dance	You put your hands in your armpits... [Junior Set (2nd)]
The CIA	The Central Intelligence Agency is responsible for keeping the U.S. government informed of foreign actions affecting the nation's interest. [Core Expansion 2, Party Box]
The Circus	A show featuring trained animals, clowns and acrobats. [Kids Set]
The Cold War	The post-World War II struggle between the US and its allies, and the former USSR and its allies. Things could have gotten hot. [Core Expansion 1, Party Box]
The Common Loon	A spotted, red-eyed diving bird -or various friends or family. [Core Expansion 1, Party Box]
The Dalai Lama	Title of the leader of Tibetan Buddhism, in exile since 1959. Hello, Dalai! [Core Expansion 3, Party Box Expansion 1]
The Dallas Cowboys	National Football League team known for their cheerleaders and their performance, both on and off the field. [Core Expansion 1, Party Box]
The Dixie Chicks	Female country and western band with pop leanings. Winners of multiple Country Music Association awards. Goodbye, Earl! [Core Expansion 3, Party Box Expansion 1]
The Dump	Just remember to recycle. [Core Set, Party Box]
The Earth	Third planet from the sun. Home to Earthlings. [Junior Set (1st) & (2nd)]
The Eiffel Tower	Designed and built by French engineer Alexandre Gustave Eiffel for the Paris World's Fair of 1889. [Core Set, Party Box]
The Electric Chair	In U.S. prisons, an alternating current of about 2000 volts is used for electrocution. [Core Set, Party Box]
The End Of The World	"It's the end of the world as we know it, and I feel fine ..." -REM [Core Expansion 1, Party Box]
The Everglades	A vast marsh covering much of southern Florida. Watch out for alligators! [Core Expansion 1, Party Box]
The Far Left	They get high Marx from some. [Core Expansion 2, Party Box]
The Far Right	Far right for some and far wrong for others. [Core Expansion 2, Party Box]
The FBI	The Federal Bureau of Investigation: the investigative agency for the U.S. Department of Justice. They're listening ... [Core Expansion 1, Party Box]
The First Day Of School	"Fear has many eyes." -Cervantes [Core Set, Party Box]
The First Day Of School	Get your backpack, your lunch, and get going! [Kids Set]
The French Riviera	Holiday home of the rich, the famous, and the half-naked. [Core Set, Party Box]
The Godfather	The 1972 critically acclaimed Mafia movie that made us as offer we couldn't refuse. [Core Expansion 1, Party Box]
The Grand Canyon	217 miles long, 4 to 18 miles wide, and more than 1 mile deeps. Now THAT'S grand. [Core Set, Party Box]
The Grateful Dead	American rock band, founded in 1965 and best known for their "Dead Head" fans. [Core Set, Party Box]
The Graveyard Shift	It WILL be the death of me . . . [Core Expansion 3, Party Box Expansion 1]
The Great Barrier Reef	Coral reefs, shoals and islets off the northern coast of Australia. Scuba heaven. [Core Expansion 3, Party Box Expansion 1]
The Great Chicago Fire	The noteworthy fire of 1871 ... a hot time in the old town ... [Core Expansion 1, Party Box]
The Great Depression	Prozac was invented six decades too late. [Core Set, Party Box]
The Great Wall Of China	A 1500 mile long wall across northern China. Built for fortification but better for tourism. [Core Expansion 3, Party Box Expansion 1]
The Green Bay Packers	Twelve time National Football League world champions, beloved by "Cheeseheads" everywhere. Are those brats done yet? [Core Set, Party Box]
The Gulf War	January - February, 1991. This six week conflict with Iraq was also known as "Desert Storm." [Core Set, Party Box]
The Ice Age	Polarity analysis of deep-sea sediment suggests the Pleistocene age began more than 1.8 million years ago. Bla-bla-bla. [Core Expansion 3, Party Box Expansion 1]
The Indy 500	Contestants must drive the full 500 miles. Bathroom breaks ARE allowed. [Core Set, Party Box]
The Internet	Computer-based worldwide information network, and global shopping market. [Core Expansion 2, Party Box]
The IRS	The Internal Revenue Service: agency of the U.S. Department of the Treasury responsible for collecting taxes. A human audity. [Core Expansion 1, Party Box]
The JFK Assassination	November 22, 1963. The funeral of President Kennedy was watched on television by millions around the world. [Core Set, Party Box]
The Judge	Smile when you play this card. [Core Expansion 3, Party Box Expansion 1]
The KKK	IF they're supposed to be the master race, why do they keep misspelling "Clan"? [Core Set, Party Box]
The Land Of Oz	"I've a feeling we're not in Kansas anymore, Toto." -Dorothy, "The Wizard Of Oz" [Core Set, Party Box]
The Last Day Of School	Almost as good as a birthday! [Junior Set (1st) & (2nd)]
The Library	Books, magazines, newspapers, tapes, and computers. SHHHH! [Junior Set (1st) & (2nd)]
The Little Mermaid	The 1837 story by Hans Christian Anderson or the 1989 animated film by Disney. Guess which made more money? [Core Expansion 1, Party Box]
The Little Mermaid	A character in a folktale who gave up her home under the sea so that she could live on land. [Kids Set]
The Lunchroom	What's for lunch? [Junior Set (2nd)]
The Mafia	A loose association of criminal groups, bound by a blood oath and sworn to secrecy. Of course, now we have to kill you. [Core Set, Party Box]
The Mall	Great place to shop and meet friends. [Junior Set (1st) & (2nd)]
The Marx Brothers	Chico, Groucho, Harpo, amd sometimes Zeppo. Their 1930s films include Duck Soup and Animal Crackers. [Core Set, Party Box]
The Metric System	No, thank you. We like our inches and feet! [Core Expansion 1, Party Box]
The Midwest	America's central plains states. They're not like folks 'round here ... [Core Set, Party Box]
The Milky Way	The galaxy that includes the sun, its solar system, and a chewy layer of caramel. [Core Set, Party Box]
The Mississippi River	The Algonquin words "Misi sipi" mean "big river." What's Algonquin for "muddy"? [Core Set, Party Box]
The Moon	There's a new moon and there's a full moon, and sometimes there's a man in the moon. [Junior Set (1st) & (2nd)]
The Mounties	The Royal Canadian Mounted Police. They always get their man. [Core Expansion 3, Party Box Expansion 1]
The National Enquirer	American tabloid newspaper. Inquiring minds want to know ... Why the heck does this thing sell? [Core Expansion 1, Party Box]
The New York Yankees	Legendary American baseball team. With so much success, it's obvious why they're reviled. [Core Set, Party Box]
The North Pole	Things can only go south from here . . . [Core Expansion 3, Party Box Expansion 1]
The NRA	National Rifle Association. They're gunning for your vote. [Core Set, Party Box]
The Ocean	How deep is the ocean? 12,000 feet. If they'd known that, maybe they wouldn't have written that stupid song. [Core Set, Party Box]
The Ocean	Almost three-fourths of the Earth's surface is covered by the four oceans. [Junior Set (1st) & (2nd)]
The Old Man And The Sea	Ernest Hemingway's classic novel - fishing, hunger, fishing, torment, fishing, personal loss ... fishing ... [Core Expansion 2, Party Box]
The Olympics	An international athletic competition held every four years. The thrill of victors and the agony of defeat. [Core Expansion 1, Party Box]
The Opera	It ain't over 'til the fat lady sings. Unfortunately, sometimes, not even then. [Core Set, Party Box]
The Ozone Layer	Short for ozonosphere. Theories about the ozone layer are full of holes. [Core Expansion 1, Party Box]
The Pentagon	The five-sided home of the U.S. Department of Defense. [Core Expansion 1, Party Box]
The Police	They keep order and arrest those who break the law. [Junior Set (1st) & (2nd)]
The President	A U.S. president must be at least 35 years old and a natural born citizen. [Junior Set (1st) & (2nd)]
The Princess & The Pea	The true test of a princess, fairy tale or otherwise. [Core Expansion 4, Party Box Expansion 1]
The Pyramids	The Egyptian pyramids were built from about 2700 BC to about 1000 BC. Tut, tut, tut ... [Core Set, Party Box]
The Renaissance	Beginning in the 1300s, started in Italy and spread across Europe. Kind of like Espresso bars ... [Core Set, Party Box]
The Rolling Stones	British "bad boy" rock band formed in 1962. Still touring? [Core Set, Party Box]
The San Andreas Fault	Geological feature in California stretching 600 miles. Like the state doesn't have enough faults already. [Core Set, Party Box]
The Scarlet Letter	Hawthorne's 1845 novel about Puritan New England, moral conflicts, guilt, and down-right nastiness. (It was an "A".) [Core Expansion 3, Party Box Expansion 1]
The South	Dixie: South of the Mason-Dixon line that is. They're not like folks 'round here ... [Core Set, Party Box]
The Statue Of Liberty	"Give me your tired, your poor/ Your huddled masses yearning to breathe free ..." -Emma Lazarus [Core Set, Party Box]
The Statue Of Liberty	"Lady Liberty" was a gift to the U.S. from the people of France. [Junior Set (2nd)]
The Super Bowl	Who needs another national holiday? [Core Expansion 2, Party Box]
The Supreme Court	The highest court in the United States. Robes, but no wigs. [Core Expansion 1, Party Box]
The Symphony	It's music to our ears. [Core Expansion 3, Party Box Expansion 1]
The Three Stooges	Nyuk, nyuk, nyuk. A wiseguy, eh? [Core Expansion 3, Party Box Expansion 1]
The Three Tenors	Opera stars Placido Domingo, Jose Carreras, and Luciano Pavarotti began recording as The Three Tenors in 1990. [Core Expansion 2, Party Box]
The Titanic	It sank in 1912. Get over it! [Core Expansion 1, Party Box]
The U.S. Constitution	We the people . . . [Core Expansion 3, Party Box Expansion 1]
The Universe	Everything. The big "It." Huge. Massive. THAT big. [Core Set, Party Box]
The Vatican	The Papal State in the middle of Rome. Home of the Pope, Swiss Guards, and lots of pigeons. [Core Expansion 1, Party Box]
The Vietnam Memorial	"The Wall," built in 1982, was designed by 21-year-old architecture student, Maya Lin. [Core Expansion 2, Party Box]
The Williams Sisters	Venus, 1980-, and Serena, 1981-, Williams, American tennis champs. One heck of a sister act. [Core Expansion 2, Party Box]
The Wright Brothers	In 1903, Wilbur and Orville made the first powered airplane flights in history. Although there were delays at the airport. [Core Set, Party Box]
The YMCA	The Young Men's Christian Association has 30 million members in 110 countries. "It's fun to stay at the Y-M-C-A." -The Village Peopl [Core Expansion 1, Party Box]
The Young & The Restless	Launched in 1973, this soap opera isn't young, but it's still restless. [Core Expansion 4, Party Box Expansion 1]
The Zoo	"Oh! Lions and tigers and bears. Oh my." [Kids Set]
Thelma & Louise	1991 Ridley Scott film starring Susan Sarandon and Geena Davis as two over-the-edge women. [Core Expansion 4, Party Box Expansion 1]
Thomas Edison	1847-1931, American inventor, developed a light bulb, generator, sound-recorder, and motion picture projector. Show off. [Core Set, Party Box]
Three Men & A Baby	The 1987 comedy film. You do the math. [Core Expansion 4, Party Box Expansion 1]
Throwing Rocks	Be careful so that you don't break any windows. [Kids Set]
Throwing Up	It's proof that you really are sick. [Kids Set]
Thunder	"Here it comes again, Thunder and Lightning..." -ELO. [Core Set, Party Box]
Thunder	A booming sound wave created by the heat from lightning. [Junior Set (1st) & (2nd)]
Thunder & Lightning	Nature's fireworks. [Core Expansion 4, Party Box Expansion 1]
Thunderstorms	Don't stand under a tree if you hear thunder! [Kids Set]
Tibet	Mountainous region of China and religious enclave for a form of Buddhism called Lamaism. Known as the roof of the world. [Core Expansion 1, Party Box]
Ticks	All ticks are bloodsucking parasites, but not all bloodsucking parasites are ticks. [Core Expansion 2, Party Box]
Tidal Waves	The gigantic ocean waves that strike with tremendous force, and cause considerable damage to life and property. Kind of like Spring Break. [Core Expansion 1, Party Box]
Tiger Woods	1975- , American star of the golf circuit. Known for his athletic skill, and youthful, classic style. [Core Expansion 2, Party Box]
Tightrope Walking	If you get really good, you can join the circus. [Junior Set (2nd)]
Timbuktu	City of 20,000 located in the West African nation of Mali. The official name if Tombouctou. From here to Timbuktu. [Core Expansion 3, Party Box Expansion 1]
Time Travel	"What do you mean I missed my connection in the 14th Century?" [Core Expansion 3, Party Box Expansion 1]
Timothy McVey	1961-2001, the Oklahoma City Bomber. [Core Expansion 3, Party Box Expansion 1]
Toasted Marshmallows	How do you like yours - golden brown or flaming? [Core Expansion 1, Party Box]
Toasted Marshmallows	Add chocolate and graham crackers and you'll wish you had s'more. [Junior Set (1st) & (2nd)]
Toasters	Wait -don't stick that fork in there! [Core Expansion 1, Party Box]
Tobacco Companies	Who says tobacco's not addictive? THEY can't give it up ... [Core Expansion 2, Party Box]
Toenails	A horse's foot is actually a toe. The hoof is a toenail. [Junior Set (1st) & (2nd)]
Toes	"This little piggy went to market ..." [Core Expansion 1, Party Box]
Tom & Jerry	A good chaser. [Core Expansion 4, Party Box Expansion 1]
Tom Cruise	1962-, American actor. It looked like Ricky Business early on, but by 1986 he was Top Gun. No Mission Impossible for him. [Core Expansion 2, Party Box]
Tom Hanks	1956-, American actor and star of such varied films as Big, Philadelphia, Forrest Gump, Saving Private Ryan and Castaway. [Core Expansion 2, Party Box]
Tomato Soup	Good with cheese sandwiches. [Junior Set (1st) & (2nd)]
Tomatoes	Most people don't know that a tomato is a fruit. [Kids Set]
Tony Blair	1951-, British Prime Minister, "We will not rest until this evil is driven from our world." Sept. 11, 2001. [Core Expansion 3, Party Box Expansion 1]
Tooth Fairy	Who knows what they do with all those baby teeth. [Junior Set (1st) & (2nd)]
Toothpaste	Brush and spit! [Junior Set (2nd)]
Top Of A Rollercoaster	Just remember: what goes UP ... [Core Set, Party Box]
Tornadoes	Funnel-shaped cloud whirling destructively at speeds up to 300 mph. "Honey, do you hear a freight train ... Honey?" [Core Set, Party Box]
Toy Poodles	They are less than ten inches tall, from their shoulders to the floor. [Junior Set (2nd)]
Toys	They're not just for Kids Set, anymore ... [Core Set, Party Box]
Toys	Stuffed animals, action figures, dolls, balls, and lots more. Everyone loves toys! [Kids Set]
Track & Field	It's eventful. [Core Expansion 4, Party Box Expansion 1]
Tractors	"She thinks My Tractor's Sexy." - Kenny Chesney [Core Expansion 3, Party Box Expansion 1]
Trailer Parks	Also known as tornado magnets. [Core Expansion 2, Party Box]
Training Wheels	It's a four-wheeler. [Junior Set (2nd)]
Trains	"The Little Engine That Could" is a story about a train that climbs over a mountain. [Kids Set]
Trampolines	Trampolines have been used in circuses wince the 18th century. Despite slumps in popularity, they always seem to bounce back! [Core Expansion 2, Party Box]
Treasure Hunting	Gold Doubloons! Gold Doubloons! AT A YARD SALE? [Core Expansion 3, Party Box Expansion 1]
Tree Huggers	"Environmentalists" to the left. "Wackos" to the right. [Core Set, Party Box]
Treehouse	A playhouse built in a tree. The Swiss Family Robinson lived in a treehouse on an island [Kids Set]
Trees	Some redwood trees in California are over 300 feet tall and thousands of years old. [Junior Set (1st) & (2nd)]
Trekkies	Beam them up, PLEASE! [Core Expansion 3, Party Box Expansion 1]
Trinidad & Tobago	Tiny, lush Caribbean republic. One of the most prosperous countries in the area due to petroleum and natural gas production. [Core Expansion 4, Party Box Expansion 1]
Truck Drivers	See the country- or at least see the highways. [Junior Set (2nd)]
Truck Stops	Breakfast 24 hours a day and you're on your way. [Core Expansion 1, Party Box]
Truth & Justice	Sounds good on paper. [Core Expansion 4, Party Box Expansion 1]
Tulips	A sign of spring! [Junior Set (2nd)]
Turkey & Stuffing	Get stuffed. [Core Expansion 4, Party Box Expansion 1]
Turkeys	Large birds raised for food. Popular at Thanksgiving. [Junior Set (1st) & (2nd)]
Turtles	They pull their legs and heads inside their shells for safety. [Kids Set]
Tyra Banks	1973-, American model, starred in Coyote Ugly. Probably the only time you'll see the words "ugly" and "Tyra Banks" in the same sentence. [Core Expansion 3, Party Box Expansion 1]
Tyrannosaurus Rex	Large carnivorous dinosaur of the latter part of the Mesozoic era. My, what big teeth you have! [Core Set, Party Box]
Umbrella Drinks	Extra fruit, please! [Core Expansion 3, Party Box Expansion 1]
Umbrellas	"Rain, rain, go away, come again another day." [Junior Set (2nd)]
Under My Bed	A good place to hide, if it's not too messy. [Kids Set]
Underwear	"Let's keep this brief." [Core Set, Party Box]
Underwear	Keep it clean! [Junior Set (2nd)]
Unicorns	Imaginary horse-like animals. A long, pointed horn grown from the middle of their foreheads. [Junior Set (1st) & (2nd)]
United Nations	The U.N. was founded in 1945, after World War II ended. Its mission is to maintain world peace. If we ever achieve it, that is ... [Core Expansion 2, Party Box]
United States	It's about 2,500 miles, from sea to shining sea. [Junior Set (2nd)]
Urban Sprawl	Oh give me a home where the edge of town roams . . . [Core Expansion 3, Party Box Expansion 1]
Vacations	"Vacation, all I ever wanted, Vacation, had to get away ..." -Go-Go's [Core Expansion 2, Party Box]
Vacuum Cleaners	It's a dirty job! [Junior Set (2nd)]
Valentine's Day	Will you be my Valentine? [Junior Set (1st) & (2nd)]
Vampires	Legendary bloodsucking monsters. [Core Expansion 2, Party Box]
Vanilla Pudding	Now available frozen, on a stick. [Junior Set (1st) & (2nd)]
Velcro	A hook-and-loop fastener that can really grab you. [Core Expansion 3, Party Box Expansion 1]
Venus & Mars	As different as men & women. [Core Expansion 4, Party Box Expansion 1]
Viagra	It works for Bob Dole, it'll work for you. [Core Expansion 3, Party Box Expansion 1]
Victorian England	An era characterized by moral severity and pompous conservatism. [Core Expansion 2, Party Box]
Video Games	Just how DO you get to the thirteenth level of "Doom"? [Core Expansion 1, Party Box]
Video Games	I told you ten hours a day was too much! [Junior Set (1st) & (2nd)]
Vietnam, 1968	More than 30,000 Americans had been killed in the Vietnam War by the end of 1968. [Core Expansion 2, Party Box]
Vincent Van Gogh	1853-90, Dutch post-impressionist painter known for dramatic sunflowers and self-portraits. Only one of his paintings sold during his lifetime. [Core Expansion 2, Party Box]
Violins	It's a pain in the neck, but keep practicing. [Core Expansion 2, Party Box]
Volcanoes	Vents in the crust of the earth from which steam, debris and molten rock spew, with explosive results. [Core Expansion 3, Party Box Expansion 1]
Volleyball	Spike it! [Junior Set (1st) & (2nd)]
VW Beetles	The prototype for the original VW Beetle was developed in 1934, and production begin in 1945. Functional, yet so fashionable. [Core Expansion 2, Party Box]
Waco, Texas	Texas city near where a 51-day standoff between law-enforcement officials and members of the Branch Davidians occurred in 1993. [Core Expansion 2, Party Box]
Waffles	Like pancakes with built-in syrup cups. [Junior Set (2nd)]
Walking The Dog	It's good exercise. [Junior Set (1st) & (2nd)]
Wall Street	The financial center of the United States. See also: roller coaster. [Core Set, Party Box]
Walt Disney	1901-1966, the head of some Mickey Mouse company. [Core Set, Party Box]
War & Peace	Tolstoy's 1805 epic novel of the Napoleonic wars, a celebration of Russian spirit. [Core Expansion 4, Party Box Expansion 1]
Warts	Small, benign, circumscribed tumors of the outer layer of the skin. Warts and all! [Core Expansion 2, Party Box]
Warts	Small, hard lumps that grow on the skin. Anyone can get them, not just witches. [Junior Set (1st) & (2nd)]
Washer & Dryer	Take them out for a spin. [Core Expansion 4, Party Box Expansion 1]
Washington, DC	City named after George Washington, it's the capital of the United States. [Junior Set (2nd)]
Watching Cartoons	Not just for Kids Set. [Junior Set (2nd)]
Watching Football	Sheer athletic prowess by players in peak physical condition is a glorious thing to behold. Pass the chips and beer. [Core Set, Party Box]
Watching Football	Isn't it more fun to PLAY football? [Junior Set (1st) & (2nd)]
Watching TV	Cartoons and commercials, movies, commercials, shows, commercials, sports, and commercials. [Kids Set]
Water	Pure water has no color, taste or smell. So, if it smells funny, don't drink it. [Junior Set (1st) & (2nd)]
Water Baloons	I'll fill them and you tie them. [Junior Set (2nd)]
Water Guns	Don't take them to school! [Junior Set (1st) & (2nd)]
Water Parks	You can go down Dead Man's Drop and I'll take the Lazy River. [Core Expansion 2, Party Box]
Water Skiing	Try it on one ski. [Junior Set (1st) & (2nd)]
Waterbeds	Could serve as a safety precaution for those who smoke in bed. [Core Expansion 1, Party Box]
Waterfalls	"Don't go chasing waterfalls..." -TLC [Core Expansion 2, Party Box]
Waterfalls	Water flowing from a cliff or other high place. Niagara Falls is over 160 feet high! [Kids Set]
Watermelon	How far can you spit the seeds? [Kids Set]
Watermelons	Pardeeville, WI - home of the Watermelon Seed-Spitting & Speed-Eating Championship. The record is 2.5 lbs. of melon eaten in 3.5 seconds. [Core Expansion 2, Party Box]
Waterparks	Wet and wild! [Junior Set (1st) & (2nd)]
Waxing The Floor	It's a pain in the neck, and back, and knees . . . [Core Expansion 3, Party Box Expansion 1]
Weapons Dealers	OK, what kind you need? Assault, Automatic, Atomic ...? [Core Expansion 1, Party Box]
Weddings	"Ding, dong, the bells are gonna chime ..." -My Fair Lady [Core Set, Party Box]
Weddings	Here comes the bride! [Kids Set]
Weed & Feed	Make sure the grass is greener on YOUR side of the fence. [Core Expansion 4, Party Box Expansion 1]
Weird Al Yankovic	1959-, American musical humorist, born Alfred Matthew Yankovic, which is nothing to laugh about . . . [Core Expansion 3, Party Box Expansion 1]
Whales	Very large animals that live in oceans. They squirt water from a blowhole. [Kids Set]
Wheat	Mainly used in flour. World output of wheat is more than 600 million metric tons a year ... so someone's making a lot of dough. [Core Set, Party Box]
Wheel Of Fortune	American TV game show, BIG MONEY! BIG MONEY!. [Core Expansion 2, Party Box]
Whipped Cream	Great on strawberry shortcake, banana splits, chocolate pudding ... [Core Expansion 1, Party Box]
Whipped Cream	Sweet and fluffy! [Junior Set (1st) & (2nd)]
Whips	"Crack that whip ... whip it, whip it good." -Devo [Core Set, Party Box]
Whips & Chains	Popular before prison reform - the good old days. [Core Expansion 4, Party Box Expansion 1]
White Bread	Plain and simple. [Junior Set (2nd)]
White Collar Crime	Three strikes and you're OUT . . . to a cozy little low-level detention facility with a pool and tennis court. [Core Expansion 3, Party Box Expansion 1]
Whoopie Goldberg	1950-, American actor and comedian. Starred in such movies as Ghost, which earned her an Academy Award. Whoopee! [Core Set, Party Box]
Will & Grace	Popular sitcom debuted in 1998. Not your average next door neighbors. [Core Expansion 4, Party Box Expansion 1]
Will Smith	1968- , Successful American rap star, TV star and wildly successful motion picture star. He's got it all. We hate him. [Core Set, Party Box]
William Shakespeare	1564-1616, The English poet and playwright. And all the world IS a stage ... [Core Set, Party Box]
Wimbledon	Strawberries ... cream ... Junior Seter tantrums ... [Core Set, Party Box]
Windsurfing	Really just surfing for lazy people. [Core Set, Party Box]
Wine Tasting	Spit or swallow? [Core Expansion 2, Party Box]
Winnie The Pooh	There's never enough honey for Pooh Bear! [Kids Set]
Winning A Trophy	Congratulations! [Junior Set (1st) & (2nd)]
Winning The Lottery	The more you play, the more THEY win. [Core Expansion 1, Party Box]
Winter	The coldest season of the year. [Junior Set (1st) & (2nd)]
Wishbone	Star of television and over 50 books. Wishbone is a Jack Russell terrier. [Junior Set (1st) & (2nd)]
Witch Hunts	Popular locations: Salem, Massachusetts and Washington, D.C. [Core Expansion 1, Party Box]
Witches	They are famous for their pointy noses, black hats and broomsticks. [Kids Set]
Women	REAL Women. [Core Expansion 2, Party Box]
Women's Soccer	The 1999 World Cup finals was the most-watched women's sporting event in history. [Core Expansion 1, Party Box]
Wood Chippers	"I guess that was your accomplice in the wood chipper." -Marge Gunderson, Fargo [Core Expansion 1, Party Box]
Woodpeckers	They find insects to eat by pecking holes in wood with their beaks. [Junior Set (2nd)]
Woodstock	The 1969 love, music and mud festival attended by 400,000. Or, the little yellow bird. [Core Expansion 1, Party Box]
Woody Allen	1935- , American comedian, actor and director, of Bananas, Annie Hall, Hannah and Her Sisters, and lots of New York Stories. [Core Expansion 2, Party Box]
Woolly Mammoth	These large hairy elephants are now extinct. [Junior Set (2nd)]
Working Out	No pain, no gain. [Core Expansion 3, Party Box Expansion 1]
Worms	A favorite food of robins. [Kids Set]
Worms	"A man may fish with the worm that hath eat of a king, and eat of the fish that has fed of that worm." -"Hamlet" Shakespeare [Core Set, Party Box]
Wrestling	A sport where two people try to force each other to the ground. No hitting allowed. [Junior Set (1st) & (2nd)]
Writing A Letter	Dear Mom, How are you? I am fine. [Junior Set (1st) & (2nd)]
X-Ray Vision	Available to Superman -for emergency use only. [Core Expansion 1, Party Box]
X-Rays	X-Rays were discovered in 1895 by the German physicist Wilhelm Conrad Roentgen. Now if they could just get those X-ray glasses down. [Core Expansion 2, Party Box]
Xena, Warrior Princess	Popular TV fantasy, adventure program. Xena, played by Lucy Lawless, and her friend Gabrielle, seek adventure and fight evil. [Core Expansion 3, Party Box Expansion 1]
Yellowstone Park	Home to 3000 geysers and hot springs. More gas and hot air than Washington, D.C. [Core Set, Party Box]
Yin & Yang	Two elements that oppose each other and give life balance. If you're lucky. [Core Expansion 4, Party Box Expansion 1]
Yo-Yos	There are lots of tricks that you can do with a yo-yo. [Kids Set]
Zebras	The stripes on each zebra are in a slightly different pattern. [Junior Set (2nd)]
Zen	Japanese form of Buddhism, originated in China. Zen again, maybe not. [Core Expansion 1, Party Box]
Zippers	Zip it, zip it good. [Core Expansion 3, Party Box Expansion 1]
Zippers	Faster than buttons. [Junior Set (2nd)]
Zombies	Undead ghouls that feed off of brains. So WE'RE safe . . . [Core Expansion 3, Party Box Expansion 1]
Zucchini	A squashed vegetable. [Core Expansion 1, Party Box]
